Kaliber|calibre|calibro
Festnahme|arrest|arrestation|arresto
geltendes Auslieferungsübereinkommen|extradition conventions in force|convention d'extradition en vigueur|vigente convenzione in materia di estradizione
zurückgewiesen werden|be subject to measures involving refusal of entry|be refused entry|faire l'objet d'une mesure de renvoi|essere oggetto di una misura di respingimento
abgeschoben werden|be subject to measures involving removal|be removed|faire l'objet d'une mesure d'expulsion|essere oggetto di una misura di espulsione
Personenkontrolle|entry check|check|checks on persons|contrôle de personnes|controllo di persone
Kontrolle des Handgepäcks|hand baggage check|contrôle des bagages à main|controllo dei bagagli a mano
Mittel zur Bestreitung des Lebensunterhalts|means of subsistence|moyens de subsistance|mezzi di sussistenza
Durchreise|transit|transito
Hoheitsgebiet einer Vertragspartei|territory of a Contracting Parties|territoire d'une Partie Contractante|territorio di una Parte contraente
einheitliche Grundsätze|uniform principles|principes uniformes|principi uniformi
Streife|mobile unit|unité mobile|unità mobile
Voraussetzungen für die Ausreise|conditions governing exit|conditions de sortie|condizioni di uscita
Kontrollpersonal|officers manning checkpoints|staff responsible for carrying out checks|personnel responsible for controls|border control officials|personnel affecté aux contrôles|personale addetto ai controlli
diplomatische und konsularische Vertretung|diplomatic and consular authority|autorité diplomatique et consulaire|autorità diplomatica e consolare
abweichen|derogate|déroger|derogare
auf dem Luftweg|by air|par voie aérienne|per via aerea
auslieferungsfähig|extraditable|pouvant donner lieu à extradition|che può dar luogo ad estradizione
Munition mit Sprengsätzen|Sprengsatzmunition|ammunition with explosive projectiles|munition à balles explosives|munizione con pallottole esplosive|munizione a pallottole esplosive
Zentrale Verhandlungsgruppe|Central Negotiating Group|Groupe central de négociation|gruppo centrale di negoziazione
elterliche Gewalt|elterliche Sorge|Obsorge|parental authority|parental responsibility|autorité parentale|potestà di genitore
Angeklagter|accused person|personne prévenue|prévenu|imputato
Abhängigkeit von Suchtstoffen und psychotropen Stoffen|Abhängigkeit von Suchtgiften und psychotropen Substanzen|addiction to narcotic drugs and psychotropic substances|dépendance à l'égard des stupéfiants et des substances psychotropes|tossicodipendenza
Hilfsflug|emergency flight|vol d'assistance|volo di soccorso
Kenndaten des Besitzers|identity of the holder|identification du détenteur|identificazione del detentore
europäischer Feuerwaffenpass|european firearms pass|carte européenne d'arme à feu|carta europea d'arma da fuoco|carta europeica d’armas da fieu
Visum für den kurzfristigen Aufenthalt|Reisevisum|short-stay visa|travel visa|visa de court séjour|visa de voyage|visto per soggiorno di breve durata|visto di viaggio
Visum mit räumlich beschränkter Gültigkeit|visa with limited territorial validity|visa à validité territoriale limitée|visto di validità territoriale limitata
an der Grenze ausgestelltes Ausnahmevisum|visa issued at the border|visa délivré à la frontière|visto in frontiera
Visum|Sichtvermerk|visa|visto
Rückreisevisum|Rückreisesichtvermerk|return visa|visa de retour|visto di reingresso|visto di ritorno
Durchreisesichtvermerk|Durchreisevisum|Transitvisum|transit visa|visa de transit|visto di transito
Kurzwaffe|kurze Feuerwaffe|short firearm|arme courte|arme à feu courte|arma corta|arma da fuoco corta
Sichtvermerkserteilung|Erteilung des Sichtvermerks|Ausstellung des Visums|issuing a visa|délivrance du visa|rilascio del visto
Langwaffe|lange Feuerwaffe|long firearm|arme longue|arme à feu longue|arma lunga|arma da fuoco lunga
Fingerabdrücke|fingerprint|fingerprint information|données dactyloscopiques|informations dactyloscopiques|dati dattiloscopici
TETRA-Standard|TETRA standard|norme TETRA|standard TETRA
Einreiseverweigerung|refusing entry|refusal of admission|non-admission|non ammissione
zugelassener Grenzübergang|authorised border crossing point|point de passage autorisé|valico autorizzato
Binnenfährverbindung|sea travel inside the Schengen area|liaison maritime intérieure|collegamento marittimo intra Schengen
Ausgleichsmaßnahme|compensatory measure|mesure de compensation|misura compensativa
mobile grenzpolizeiliche Kräfte|mobile units of the border police|forces mobiles de la police des frontières|unità mobile di polizia
Grenzschutzbehörde|authority responsible for border protection|autorités chargées de la protection des frontières|autorità di frontiera
Seehafenbetreiber|seaport operator|exploitant de port|società portuale
Flugbetreiber|airport operator|exploitant d'aéroport|società aeroportuale
Grenzübertrittsdokument|cross-border travel document|document transfrontières|documento di viaggio
Kompensationsmittel|compensatory measure|instrument de compensation|strumento compensativo
Landeplatz|aerodrome|aéroport secondaire|aérodrome|aeroporto minore
Hilfspolizeibeamter|extra police officer|agent de police auxiliaire|agente di controllo ausiliario
Emblem der Europäischen Union|European Union emblem|emblème de l'Union européenne|emblema dell'Unione europea
einheitliche Ausschilderung|uniformity of signs|signalisation uniforme|indicazione uniforme
automatisierte Grenzkontrolle|automated border control|contrôle frontalier automatique|controllo di frontiera automatizzato
Verringerung der Gültigkeitsdauer des einheitlichen Visums|shortening of the length of validity of the uniform visa|réduction de la durée de validité du visa uniforme|riduzione della durata di validità del visto uniforme
Gepäckkontrolle|Gepäckskontrolle|control on baggage|contrôle des bagages|controllo di bagaglio
innergemeinschaftlicher Flug|intra-Community flight|vol intracommunautaire|volo intracomunitario
Kriegswaffe|weapon of war|arme de guerre|arma da guerra
Benelux-Wirtschaftsunion|Benelux Economic Union|Union économique Benelux|Unione economica del Benelux
Jahresbericht|Tätigkeitsbericht|annual report|rapport d'activité|relazione annuale
Hoheitsgebiet eines Schengen-Staates|territory of a Schengen State|territoire d'un Etat Schengen|territorio di uno Stato Schengen
Vertragspartei|Contracting Party|party|Partie Contractante|partie contractante|Parte contraente
Entlastung|discharge|décharge|discarico
Reisedokument|travel document|document de voyage|documento di viaggio
Entscheidungsbefugnis|decision-making powers|compétence décisionnelle|potere decisionale
Erwägungsgründe|Präambel|preamble|préambule|considerando
Regierungskonferenz|Intergovernmental Conference|Conférence intergouvernementale|conferenza intergovernativa
Gebietseinheit|territorial unit|unité territoriale|entità territoriale
Leiter der lokalen Polizei|Leiter der örtlichen Polizei|local police chief|chef de la Police locale|responsabile della polizia locale
Ausländeramt|Fremdenpolizei|Aliens Department|Office des étrangers|Ufficio degli stranieri
Präfektur|prefecture|Préfecture
Ausländeramt-Polizeipräfektur|prefecture of the police of the Italian Republic|Service des Etrangers de la Préfecture de police de la République|Ufficio degli Stranieri - Questura della Repubblica
Pass- und Visastelle des Aussenministeriums|passport and visa office at the Ministry of Foreign Affairs|Service des passeports et visas du Ministère des Affaires étrangères|Servizio passaporti e visti del Ministero degli Affari esteri
zuständige Verwaltungsbehörde|competent administrative authority|autorité administrative compétente|autorità amministrativa competente
Aufhebung des Visums|Aufhebung des einheitlichen Visums|revocation of a visa|rescission of a visa|rescission of uniform visa|abrogation de visa|abrogation de visa uniforme|revoca del visto
Familienzusammenführung|family reunification|rapprochement familial|ricongiungimento familiare
Formvorschrift|formal rule|prescription de forme|prescrizione di forma
Unterrichtungsverfahren|notification procedure|procédure de notification|procedura di notifica
Beweiskraft|probative force|force probante|valore probatorio
Indiz|indicative evidence|indice|indizio
Beweis|probative evidence|preuve|prova
Beweismittel|evidence|élément de preuve|preuve|elemento di prova
Aufnahmegesuch|request to take charge|demande de prise en charge|richiesta
Überstellungsbeschluss|transfer decision|décision de transfert|decisione di trasferimento
Flüchtlingseigenschaft|refugee status|qualité de réfugié|status di rifugiato
Bestimmungsmitgliedstaat|Member State of destination|Etat membre de destination|Stato membro di destinazione
Einreisevisum|entry visa|visa d'entrée|visto d'entrata
aufschiebende Wirkung|suspensory proceedings|procédure suspensive|effetto sospensivo
Flüchtling|refugee|réfugié|rifugiato
Treffer|hit|résultat positif|risposta pertinente
Aufgliederung der Daten|breakdown of data|ventilation des données|strutturazione dei dati
Abnahme von Fingerabdrücken|collection of fingerprints|relevé des empreintes digitales|rilevamento delle impronte digitali
Herkunftsmitgliedstaat|Member State of origin|Etat membre d'origine|Stato membro d'origine
Entführer|abductor|ravisseur|rapitore
Gefahrengutrecht|regulations on hazardous goods|droit relatif au transport des marchandises dangereuses|leggi relative al trasporto di merci pericolose
Justizvorbehalt|judicial consent proviso|réserve des autorités judiciaires|riserva di accordo delle autorità giudiziarie
Kfz-Kennzeichen|vehicle registration number|numéro de plaque minéralogique|numero di targa
Verkehrsregisterbehörde|Kraftfahrzeugzulassungsbehörde|Kfz-Zulassungsbehörde|Verkehrsamt|Kfz-Anmeldung|vehicle registration authority|service d'immatriculation|ufficio della motorizzazione
Hinterlegung der Ratifikationserklärung|Hinterlegung der Ratifikationsurkunde|Hinterlegung der Ratifizierungsurkunde|depositing the instrument of ratification|dépôt des instruments de ratification|deposito dello strumento di ratifica
Dienstbescheinigung|certificate of duty|attestation de fonction|attestato di funzione
Schranke|Schranken|Schlagbaum|security ramp|barrière|barrière de contrôle|barriera di controllo
Leitplanke|Leitschranke|crash barrier|glissière de sécurité|guardrail
ETSI|European Telecommunications Standards Institute|Europäische Institut für Telekommunikationsnormen|Institut européen des normes de télécommunication|Istituto europeo delle norme di telecomunicazione
digitales Funknetz|digital radio communications network|réseau radio numérique|rete di radiocomunicazione numerica
Reizstoffsprühgerät|self-defence spray|bombe d'autodéfense|spray irritant|spray irritante
Produktionsland|Herstellungsland|country of origin|pays de production|paese di produzione
Küstenwache|coastguard|garde-côtes|guardia costiera
Einsatzort|assignment location|lieu d'intervention|sede d'intervento
rechtliche Rahmenbedingungen|legal framework|cadre juridique|condizioni giuridiche di base
Schwerkriminalität|serious crime|criminalité lourde|grande criminalità
vertretender Staat|representing State|Etat représentant|Stato rappresentante
konsularische Vertretung|consular post of the State|représentation consulaire|rappresentanza consolare
Ausländerausweis|Personalausweis für Ausländer|alien's identity card|carte d'identité d'étranger|carta d'identità per stranieri
Aufenthaltserlaubnis|Aufenthaltsgenehmigung|Aufenthaltsbefugnis|residence permit|autorisation de séjour|permesso di soggiorno|autorizzazione di soggiorno
Niederlassungsbewilligung|Genehmigung zur Niederlassung|permanent residence permit|autorisation d'établissement|permesso di stabilimento|permesso di residenza
Diplomatenausweis|diplomat's pass|carte diplomatique|tessera per agenti diplomatici
Ausweis|pass|carte|tessera
Personalausweis|identity card|carte d'identité|carta d'identità
Angehöriger eines Mitgliedsstaates der EG|residence permit for EC nationals|ressortissant communautaire|cittadino della Comunità europea
Aufenthaltsbewilligung|residence authorisation|permis de séjour|autorizzazione di soggiorno
Aufenthaltskarte|temporary residence permit|carte de séjour temporaire|permesso di soggiorno temporaneo
Karte für Ansässige|resident's card|carte de résident|permesso di residenza
Legitimationstitel|certificate|titre de légitimation|titolo di riconoscimento
Aufenthaltserlaubnis|residence permit|carte de séjour|carta di soggiorno
Ausländerdokument|document for aliens|document pour étranger|documento per stranieri
ESA|Europäische Weltraumorganisation|European Space Agency|Agence spatiale européenne|ASE; ESA|Agenzia spaziale europea
EPA|Europäisches Patentamt|EPO|European Patent Office|OEB|Office européen des Brevets|Ufficio europeo dei brevetti
ITPA|International Tea Promotion Association|Association internationale pour la promotion du thé|AIPT|Associazione internazionale per la promozione del tè
Internationales Amt für nationale Agrarforschung|ISNAR|International Service for National Agriculture Research|SIRAN|Service international pour la recherche agricole nationale|Servizio internazionale per la ricerca agricola nazionale
Technisches Zentrum für Zusammenarbeit in der Landwirtschaft und im ländlichen Bereich|ACP|Technical Centre for Agricultural and Rural Cooperation|CTA|Centre technique de coopération agricole et rurale|Centre technique de coopération agricole et rurale ACP-EU|Centro tecnico di cooperazione agricola e rurale
Institut für neue Technologien|UNU-INTECH|United Nations University Institute for New Technologies|Institut des nouvelles technologies|Istituto delle nuove tecnologie
AMSCO|African Management Services Company
Legitimationskarte|accreditation pass|carte de légitimation|carta d'identità
Wiedereinreisesichtvermerk|re-entry visa|visa de retour|visto di reingresso
Einreise-Sichtvermerk|entry visa|visa d'entrée|visto d'ingresso
gewöhnlicher Sichtvermerk|ordinary visa|visa ordinaire|visto ordinario
Bankbürgschaft|legal guarantee from a bank|garantie légale d'une banque|garanzia bancaria
Transporttitel|ticket|titre de transport|documento di trasporto
telegraphische Geldanweisung|telegraphic money order|mandat télégraphique|vaglia telegrafico
Hinterlegung einer Sicherheitsleistung|guarantee deposited|dépôt d'une garantie|deposito di una prestazione di garanzia
Richtbetrag|reference amount|montant de référence|importo di riferimento
Aufkleber|sticker|vignette adhésive|visto adesivo
Sicherheitsmerkmal|security feature|dispositif de sécurité|caratteristica di sicurezza
Wohnsitzstaat|State which is not the applicant's State of residence|Etat de résidence|Parte contraente di residenza
persönliches Gespräch|personal interview|entretien personnel|colloquio personale
Visastelle|visa section|service des visas|servizio visti
Verpflichtungserklärung|formal obligation|déclaration de prise en charge|dichiarazione di garanzia
Sportwettkampf|target shooting|compétition sportive|competizione sportiva
halbautomatische Feuerwaffe|halbautomatische Schusswaffe|halbautomatische Waffe|Halbautomat|Selbstladewaffe|Selbstlader|semi-automatic long firearm|arme à feu semi-automatique|arme semi-automatique|arma semiautomatica|semiautomatica|arma a ricarica automatica|caricatore automatico
Repetierwaffe|repeating firearm|arme à répétition|arma a ripetizione
panzerbrechende Munition|ammunition with penetrating projectile|munition à balles perforantes|munizione a pallottole perforanti
Ansässiger|ansässige Person|resident of the country|résident|residente del paese|persona residente
Besitzer|person in possession of a firearm|détenteur|detentore
Erwerber|person acquiring a weapon|acquéreur|acquirente
Erwerbsmitgliedstaat|Member State of acquisition|Etat membre d'acquisition|Stato membro di acquisizione
Waffenhändler|dealer|armurier|armaiolo
verlängertes Visum|extended visa|visa prolongé|visto prorogato
Grenzkontrollbeamter|officer responsible for border controls|agent chargé du contrôle à la frontière|agente addetto al controllo alla frontiera|agente addetto al controllo in frontiera
Visamarke|Schengen-Visumetikett|visa sticker|vignette visa|vignette-visa|vignette Schengen|vignette visa Schengen|vignetta visto|vignetta Schengen|vignetta visto Schengen
Kinegramm|kinegramme|kinégramme|kinegramma
Visuminhaber|holder of visa|titulaire du visa|titolare del visto
Art des Reisedokuments|travel document type|nature du document de voyage|natura del documento di viaggio
Nummer des Reisedokuments|issue number of the document|numéro du document de voyage|numero del documento di viaggio
Nummer der Visamarke|visa sticker number|numéro de la vignette visa|numero della vignetta visto
Datum der Ausstellung des Visums|Ausstellungsdatum des Visums|date of issue of the visa|date de la délivrance du visa|data del rilascio del visto
Datum der Annullierung|date of cancellation|date de l'annulation|data dell'annullamento
Datum des Grenzübertritts|date on which the border is crossed|date du franchissement de la frontière|data del passaggio della frontiera
Annullierung des Visums|Annullierung des einheitlichen Visums|annulment of a visa|cancellation of visa|visa cancellation|annulation de visa|annulation de visa uniforme|annullamento del visto|annullamento del visto uniforme
Ausgleichszahlungen|compensatory payments|frais de régularisation|spese di regolarizzazione
Verursacherprinzip|principle that the generator is liable|principe demandeur-payeur|principio del chi chiede paga
Konsultationsverfahren|consultation procedure|procédure de consultation|procedura di consultazione
gemeinsamer Ein- und Ausreisestempel|common entry and exit stamp|timbre commun d'entrée et de sortie|timbro comune d'ingresso e d'uscita
GKI|Gemeinsame Konsularische Instruktion|Gemeinsame Konsularische Instruktion an die diplomatischen Missionen und die konsularischen Vertretungen der Vertragsparteien des Schengener Durchführungsübereinkommens, die von Berufskonsularbeamten geleitet werden|CCI|Common Consular Instructions|Common Consular Instructions for the Diplomatic Missions and Consular Posts|ICC|Instruction consulaire commune|Instruction consulaire commune adressée aux représentations diplomatiques et consulaires de carrière des parties contractantes de la convention de Schengen|Istruzione consolare comune|Istruzione consolare comune diretta alle Rappresentanze diplomatiche e consolari di prima categoria delle Parti contraenti dell'Accordo di Schengen
Schaffung eines einheitlichen Sichtvermerks|introduction of a uniform visa|instauration du visa uniforme|introduzione del visto uniforme
Sichtvermerk, dessen Gültigkeit räumlich beschränkt ist|visa whose validity is subject to territorial limitation|visa dont la validité fait l'objet d'une limitation territoriale|visto, la cui validità è oggetto di una limitazione territoriale
Datum der ersten Einreise|date of first entry|date de la première entrée|data del primo ingresso
Aufenthaltstitel|residence permit|titre de séjour|titolo di soggiorno|titolo di residenza|autorizzazione di soggiorno (3
Ausreisestempel|exit stamp|cachet de sortie|timbro di uscita
einheitliche Gestaltung der Aufenthaltstitel|uniform format for residence permits|modèle uniforme de titre de séjour|modello uniforme per i permessi di soggiorno
Einreisestempel|entry stamp|cachet d'entrée|timbro di ingresso
Meldevordruck|Gästeblatt|registration form|fiche de déclaration|scheda di dichiarazione
vorläufiger Aufenthaltstitel|provisional residence permit|autorisation provisoire de séjour|autorizzazione provvisoria di soggiorno
besonderes unveränderliches physisches Merkmal|besonderes Kennzeichen|specific objective physical characteristic not subject to change|signe physique particulier, objectif et inaltérable|segno fisico particolare, oggettivo ed inalterabile
Pflanzengesundheitszeugnis|plant health certificate|certificat phytosanitaire|certificato fitosanitario
Ausweispapiere|document d'identité|documento d'identità
Beförderungsgenehmigung|autorisation de transport|autorizzazione di trasporto
Aufenthaltserlaubnis|residence permit|titre de séjour|titolo di soggiorno
humanitäre Erwägung|humanitärer Grund|humanitarian ground|humanitarian reason|motif humanitaire|raison humanitaire|motivo umanitario|motiv umanitar
die Ausschreibung zurückziehen|withdraw the alert|procéder au retrait du signalement|procedere al ritiro della segnalazione
Drittstaat|third State|Etat tiers|Stato terzo|Paese terzo
Drittausländer, welcher nicht über die erforderlichen Reisedokumente verfügt|alien who do not possesses the necessary travel documents|étranger qui n'est pas en possession des documents de voyage requis|straniero che non è in possesso dei documenti di viaggio richiesti
Verletzung der Rechtsvorschriften|breach of the laws|violation de la législation|violazione della legislazione
Bescheinigung der zuständigen Behörden|certificate from the competent authorities|attestation des autorités compétentes|attestazione delle autorità competenti
Asylbegehren|Asylantrag|application for asylum|demande d'asile|domanda di asilo
geographische Beschränkung|geographic restriction|restriction géographique|restrizione geografica
Gültigkeitsdauer|period of validity|durée de validité|durata di validità
Erteilung einer Aufenthaltserlaubnis|issuing of a residence permit|délivrance du titre de séjour|rilascio del titolo di soggiorno
sichtvermerksfrei|von der Sichtvermerkspflicht befreit|exempted from the visa requirement|through exemption from the visa requirement|au bénéfice d'une dispense de visa|dispensé de l'obligation du visa|con dispensa dal visto|esonerato dall'obbligo del visto
Durchreisestaat|country of transit|pays de transit|paese di transito
Bestimmungsvertragspartei|Contracting Party of destination|Partie Contractante de destination|Parte contraente di destinazione
Stellung eines Asylbegehrens|Stellung eines Asylantrags|lodge an application for asylum|dépôt d'une demande d'asile|presentazione di una domanda di asilo
für die Behandlung des Asylbegehrens zuständige Vertragspartei|für die Behandlung des Asylantrags zuständige Vertragspartei|Contracting Party responsible for processing the application for asylum|Partie Contractante responsable du traitement de la demande d'asile|Parte contraente responsabile per l'esame della domanda di asilo
den Aufenthalt gewähren|grant an alien the right of residence|accorder le droit de séjour|concedere il diritto di soggiorno
Familienangehöriger|family member|membre de la famille|membro della famiglia
Identität|identity|identité|identità
Nummer|reference|référence|riferimento
ausstellende Behörde|issuing authority|autorité ayant effectué la délivrance|autorità rilasciante
Ort der Ausstellung|Ausstellungsort|place of issue|lieu de délivrance|luogo del rilascio
Aufenthaltsort|place of residence|lieu de séjour|luogo di soggiorno
Reiseweg|Reiseroute|routes travelled|itinéraire de voyage|itinerario di viaggio
ausgestellter Sichtvermerk|erteilter Sichtvermerk|visa issued|visa délivré|visto rilasciato
Ort der Einreichung des Asylbegehrens|Ort der Einreichung des Asylantrags|place where the application for asylum was lodged|lieu où la demande d'asile a été déposée|luogo in cui è stata presentata la domanda di asilo
Datum der Einreichung des Asylbegehrens|Datum der Einreichung des Asylantrags|date on which the application was lodged|date de présentation d'une demande d'asile|data di presentazione di una domanda di asilo
Verfahrensstand|stage reached in the procedure|Etat d'avancement de la procédure|stato della procedura
Entscheidungstenor|decision taken|teneur d'une décision|contenuto di una decisione
Entscheidungsgründe|grounds for the decision|motifs de la décision|motivi addotti
Berichtigung der Daten|correction of information|rectification des informations|rettifica delle informazioni
vorbeugende Bekämpfung von strafbaren Handlungen|Verhütung von Straftaten|Kriminalprävention|preventing criminal offences|prévention de faits punissables|prevenzione di fatti punibili
Spezialitätsgrundsatz|principle of speciality|principe de la spécialité|règle de la spécialité|principio di specialità
phytosanitäre Anforderungen|plant health requirements|exigences phytosanitaires|requisiti fitosanitari
einheitlicher Sichtvermerk|einheitliches Visum|uniform visa|visa uniforme|visto uniforme
Person, die im Verdacht steht, an einer auslieferungsfähigen Straftat beteiligt zu sein|person who is presumed to have participated in an extraditable criminal offence|personne présumée avoir participé à un fait punissable pouvant donner lieu à extradition|persona che si presume abbia partecipato alla commissione di un reato
Beamter einer Vertragspartei|officer of a Contracting Party|agent d'une Partie Contractante|agente di una Parte contraente
aufgegebenes Reisegepäck|registered baggage|checked-in baggage|checked-in luggage|bagage enregistré|bagage de soute|bagaglio registrato
Durchsuchung|search|fouille|perquisizione
Grenzkontrolle|border check|contrôle frontalier|controllo di frontiera
grenzüberschreitende Observation|cross-border surveillance|observation transfrontalière|osservazione transfrontaliera
Grenzübertritt|crossing the border|franchissement de la frontière|passaggio della frontiera
Handgepäck|cabin baggage|hand baggage|hand luggage|bagage à main|bagaglio a mano
Sicherheitsdurchsuchung|security search|fouille de sécurité|perquisizione di sicurezza
amtliche Anzeige|official report|dénonciation officielle|denuncia ufficiale
aufgreifen|ergreifen|apprehend|appréhender|fermare
Auslieferung|extradition|estradizione
Ausschreibungskategorie|category of alerts|catégorie de signalement|categoria di segnalazioni
Beförderung|Überstellung|transfer|transfert|trasferimento
Beschlagnahme|Beschlagnahmung|seizure|saisie|sequestro
eine Festnahme vornehmen|make an arrest|procéder à une arrestation|procedere ad un arresto
Ersuchen um Auslieferung und Durchbeförderung|request for extradition and transit|demande d'extradition et de transit|domanda di estradizione e di transito
Festhalterecht|right to apprehend|droit d'interpellation|diritto di fermare la persona
Festnahme aufgrund der Ausschreibung|arrest on the basis of an alert|arrestation au motif du signalement|arresto in seguito alla segnalazione
Festnahme mit dem Ziel der Auslieferung|arrest for extradition purposes|arrestation aux fins d'extradition|arresto ai fini di estradizione
Freiheitsstrafe|Strafhaft|sentence involving deprivation of liberty|peine privative de liberté|pena privativa della libertà
förmliche Zustellung|amtliche Zustellung|a document is to be served in person|notification à personne|notificazione alla persona|notificazione formale|notificazione
Haftbefehl|arrest warrant|mandat d'arrêt|mandato d'arresto|ordine di arresto
persönliches Erscheinen|appear in person|comparution personnelle|comparution|comparizione personale
Rückführung|repatriation|rapatriement|allontanamento|rimpatrio
Rückübernahme|readmission|réadmission|riammissione
Zulassung|admission|ammissione
Übernahmepolitik|Rückübernahmepolitik|readmission policy|politique de réadmission|politica di riammissione
Überstellungspolitik|transfer policy|politique de transfert|Politica di trasferimento
Übertragung der Vollstreckung von Strafurteilen|transfer of the enforcement of criminal judgments|transmission de l'exécution des jugements répressifs|trasmissione dell'esecuzione delle sentenze penali
Advanced-Passenger-Information-System|APIS|Advanced Passenger Information System|API system|système de renseignements préalables concernant les voyageurs|système RPCV|système d'informations anticipées sur les passagers|Sistema di informazione anticipata sui passeggeri
Entsendung von Verbindungsbeamten|secondment of liaison officers|détachement de fonctionnaires de liaison|assegnazione di funzionari di collegamento
Ermittlungsverfahren|criminal investigation|enquête judiciaire|indagine giudiziaria|inchiesta|indagine
Ersuchen um Übernahme der Vollstreckung der Strafe|request that the enforcement of the penalty remaining to be served be taken over|demande de reprise de l'exécution de la peine|domanda di continuazione dell'esecuzione della pena, della misura di sicurezza
finanzielles Ungleichgewicht|financial imbalance|déséquilibre financier|squilibrio finanziario
Geldbusse|Geldstrafe|financial penalty|sanction pécuniaire|sanzione pecuniaria|multa o pena pecuniaria|pena pecuniaria
Meldepflicht|requirement to report to the authorities|obligation de déclaration|obbligo di dichiarare la propria presenza
Pre-Flight-Inspection|pre-flight-inspection|contrôles en amont|Pre-flight-Inspection
Pull-Faktor|pull factor|facteur d'attraction
Vollstreckung einer Strafe|enforcement of the detention order|exécution d'une peine|esecuzione di una pena
örtlich zuständige Behörde|competent local authorities|autorité localement compétente|autorità localmente competente
Dokument, aus dem sich ergibt, dass die Zustimmung erteilt worden ist|document certifying that authorisation has been granted|document attestant que l'autorisation a été accordée|documento attestante che l'autorizzazione è stata accordata
Dienstwaffe|service weapon|arme de service|arma di ordinanza
anhalten|challenge|interpeller|fermare
Verjährung|limitation of actions|prescription|prescrizione
öffentliche Sicherheit und Ordnung|öffentliche Ordnung und Sicherheit|public order and security|ordre et sécurité publics|ordine pubblico e sicurezza pubblica
rechtmäßig in das Hoheitsgebiet einer der Vertragsparteien einreisen|enter the territory of a Contracting Party legally|rentrer régulièrement sur le territoire de l'une des Parties Contractantes|entrare regolarmente nel territorio di una delle Parti contraenti
zu observierende Person|person under surveillance|personne observée|persona che è oggetto dell'osservazione
Beamter der Kriminalpolizei bei der Staatsanwaltschaft|Kriminalbeamte im Auftrag der Justiz|member of the police judicaire près les Parquets (1)  |Criminal Police attached to the Public Prosecutor's Office|membre de la police judiciaire près le Parquet|membro della police judiciaire près le Parquet
Beamter der Gendarmerie|member of the gendarmerie|membre de la gendarmerie|membro della gendarmerie
Beamter der Gemeindepolizei|member of the police municipale |member of the municipal police|membre de la police communale|membro della police communale
Zollbeamter|customs officer|agent des douanes|doganiere
Beamter des Zollfahndungsdienstes|officer of the Zollfahndungsdienst|officer of the customs investigation service|service de recherches douanières|agente dello Zollfahdungsdienst
Beamter der kriminalpolizeilichen Abteilungen der Nationalen Polizei oder der Nationalen Gendarmerie|Hilfsbeamter der kriminalpolizeilichen Abteilungen der Nationalen Polizei oder der Nationalen Gendarmerie|criminal police officer of the national police or national gendarmerie|agent de police judiciaire de la police nationale ou de la gendarmerie nationale|agent de police judiciaire|agente di polizia giudiziaria della "police nationale" e della "gendarmerie nationale"
Beamter der Nationalen Gendarmerie|police officer of the national gendarmerie|agent de la gendarmerie nationale|agente della gendarmerie nationale
Rauschgiftspürhund|Suchtgiftspürhund|sniffer dog|chien-drogue|chien anti-drogue|chien anti-stupéfiants|cane addestrato a scoprire la droga
Beamter der kriminalpolizeilichen Abteilung der Nationalen Polizei|criminal police officer of the national police|officier de police judiciaire de la police nationale|ufficiale di polizia giudiziaria della "police nationale" e della "gendarmerie nationale"
Beamter der Reichspolizei|officer of the Rijkspolitie|officer of the national police|agent de la Rijkspolitie|agente della Rijkspolitie
Beamter der Gemeindepolizei|officer of the Gemeentepolitie|officer of the municipal police|agent de la Gemeentepolitie|agente della Gemeentepolitie
Beamter des fiskalischen Nachrichten- und Fahndungsdienstes|officer of the tax inspection and investigation authorities responsible for import and excise duties|agent du service fiscal de renseignements et de recherche|agente del servizio fiscale di informazioni e ricerca
Generalkommissariat der Kriminalpolizei|Commissariat général de la Police judiciaire|Criminal Investigation Department
Bundeskriminalamt|Federal Crime Office
Zentraldirektion der Kriminalpolizei|Direction centrale de la Police judiciaire|Central Headquarters of the Criminal Police
Generalstaatsanwalt|Procureur général d'Etat|Principal State Prosecutor
Abschiebungsverpflichtung|obligation to expel|obligation d'éloignement|obbligo di allontanamento
nationale Ausschreibung|Inlandsauschreibung|alert|signalement national|segnalazione
Ausschreibung zur Einreiseverweigerung|alert for the purposes of refusing entry|signalement aux fins de non-admission|segnalazione ai fini della non ammissione
Entfernung|Abschiebung|Rückführung|Ausweisung|expulsion|éloignement|mesure d'éloignement|allontanamento
förmliches Auslieferungsverfahren|formal extradition proceedings|procédure formelle d'extradition|procedura formale di estradizione
grenzüberschreitende Nacheile|cross-border hot pursuit|poursuite transfrontalière|inseguimento transfrontaliero
rechtskräftiges Urteil|enforceable judgment|jugement exécutoire|sentenza esecutiva
Strafverfolgung|prosecution|criminal prosecution|poursuite pénale|azione penale|procedimento penale|perseguimento penale
Staatsanwalt|Landelijk Officier van Justitie|National Public Prosecutor
Einziehung des Aufenthaltstitels|withdrawing the residence permit|retrait du titre de séjour|ritiro del titolo di soggiorno
Ausschreibungsgrund|reason for the alert|motif du signalement|motivo di segnalazione
Ausschreibung zur Aufenthaltsermittlung|alert for the purposes of communicating the place of residence|signalement aux fins de communication du lieu de séjour|segnalazione per comunicare il luogo di soggiorno
ausgewiesen werden|be subject to measures involving deportation|be deported|faire l'objet d'une mesure d'éloignement|essere oggetto di una misura di allontanamento
Durchsetzungsaufschub|report de l'éloignement|rinvio dell'esecuzione
Durchsuchung|Hausdurchsuchung|search|perquisition|perquisizione
Verfolgung von Straftaten|prosecuting criminal offences|poursuite de faits punissables|perseguimento di fatti punibili|ricerca di fatti punibili
zu ergreifende Maßnahme|erbetene Maßnahme|action to be taken|requested action|conduite à tenir|linea di condotta da seguire
rechtmäßige Aufgabe|lawful task|tâche légale|compito legale
grenzüberschreitende polizeiliche Zusammenarbeit|cross-border police cooperation|coopération policière transfrontalière|Cooperazione transfrontaliera tra forze di polizia|Collaborazione tra le polizie
internationale Rechtshilfe zur Bekämpfung des Betäubungsmittelverkehrs|internationale Rechtshilfe zur Bekämpfung des Suchtmittelverkehrs|international judicial assistance in combating drugs trafficking|entraide répressive internationale en matière de lutte contre le trafic de stupéfiants|assistenza internazionale reciproca in materia di lotta contro il traffico di stupefacenti
justizielle Zusammenarbeit|cooperation between the judicial authorities|coopération judiciaire|cooperazione giudiziaria
konsularische Zusammenarbeit|consular cooperation|coopération consulaire|cooperazione consolare|collavuraziun consulara
polizeiliche und justizielle Rechtshilfe in Strafsachen|mutual police and judicial assistance in criminal matters|entraide policière et judiciaire en matière pénale|assistenza giudiziaria e fra polizie in materia penale
repressive Verbrechensbekämpfung|combating crime by means of law enforcement|lutte répressive contre la criminalité|lotta repressiva contro la criminalità
gegenseitige Unterstützung|mutual assistance|assistance mutuelle|mutua assistenza
Asylverfahren|asylum procedure|procédure d'asile|procedura di asilo
ein Gutachten abgeben|deliver an opinion|émettre un avis|esprimere un parere
präventive Verbrechensbekämpfung|combating crime by means of prevention|lutte préventive contre la criminalité|prévention de la délinquance|lotta preventiva contro la criminalità
Verstoß gegen die gesetzlichen Vorschriften über Waffen und Sprengstoffe|Verletzung der gesetzlichen Vorschriften über Waffen und Sprengstoffe|breach of the laws on arms and explosives|infraction aux dispositions légales en matière d'armes et explosifs|infrazione alle normative in materia di armi ed esplosivi
Identifizierungsnummer der Feuerwaffe|Identifizierungsnummer|Identifizierungsnummer der Schusswaffe|serial number of the firearm|serial number|numéro d'identification d'une arme à feu|numéro d'immatriculation|numero di matricola dell'arma da fuoco|numero di matricola
Justizdokumentation|Strafregister|judicial record|casier judiciaire|casellario giudiziario
erkennbar|identifiable|facilmente identificabile
Uniform|uniform|uniforme
Armbinde|armband|brassard|bracciale
an dem Fahrzeug angebrachte Zusatzeinrichtung|accessory fitted to the vehicle|dispositif accessoire placé sur le véhicule|accessori posti sopra il veicolo
getarntes Polizeifahrzeug|Zivilfahrzeug|unmarked vehicle|véhicule banalisé|veicolo camuffato
Handschellen|handcuffs|menottes|manette
Nacheilerecht|Recht der polizeilichen Nacheile|right of hot pursuit|droit de poursuite|diritto di inseguimento da parte della polizia
Rechtsnachfolger|person entitled on another's behalf|ayant droit|avente diritto
Übermittlung von Informationen|transmission of information|transmission d'informations|trasmissione di informazioni
Entsendung von Verbindungsbeamten|posting liaison officers|affectation de fonctionnaires de liaison|assegnazione di funzionari di collegamento
Erweiterung der Frequenzbänder|widening the frequency bands|élargissement des bandes de fréquences|ampliamento delle bande di frequenze
Entsorgungsinfrastruktur|infrastructure for waste disposal|infrastructure d'élimination|infrastruttura di smaltimento
genormtes und kompatibles Kommunikationssystem|standardised and compatible communication system|système de communication normalisé et compatible|sistema di comunicazione normalizzato e compatibile
Beherbergungsstätte|Beherbergungsbetrieb|Unterkunft|establishment providing accommodation|établissement d'hébergement|struttura che fornisce alloggio
sich ausweisen|confirm one's identity|justifier de son identité|provare la propria identità
Vermisster|Vermisste|Abgängiger|Abgängige|missing person|personne disparue|persona scomparsa
Bekämpfung von Straftaten|combating crime|répression d'infractions|repressione di futuri reati
Verhütung von Straftaten|preventing offences|prévention d'infractions|prevenzione di reati
Zustellung von Urkunden|service of judicial documents|notification de communications judiciaires|notificazione di comunicazioni giudiziarie
Überstellung von verurteilten Personen|transfer of sentenced persons|transfèrement de personnes condamnées|trasferimento di condannati|transferiment
Hinterziehung von Verbrauchsteuern|evasion of excise duties|fraude aux droits d'accises|frode in materia di accise
Handlung, die mit einer Geldbusse oder -strafe geahndet wird|act punishable by a fine|fait passible d'une amende|fatto passibile di pena pecuniaria
Erledigung von Rechtshilfeersuchen|Durchführung von Rechtshilfeersuchen|admissibility of letters rogatory|recevabilité de commissions rogatoires|ricevibilità di rogatorie
Vorladung|summons to appear|citation à comparaître|citazione
Zwangsandrohung|notice of penalty|injonction|ingiunzione
Ersuchen um Durchbeförderung von Personen|request for the transit of persons|demande de transit de personnes|domanda di transito di persone
Ratifikation eines Übereinkommens|ratification of a Convention|ratification d'une convention|ratifica di una convenzione
IKPO/INTERPOL|Internationale Kriminalpolizeiliche Organisation|INTERPOL|ICPO-INTERPOL|International Criminal Police Organisation|O.I.P.C.-INTERPOL|Organisation internationale de Police Criminelle|Organizzazione internazionale di polizia criminale
Annahme eines Übereinkommens|accepting a Convention|acceptation d'une convention|accettazione di una convenzione
ausliefern|extradite|extrader|estradare
Unterbrechung der Verjährung|Hemmung der Verjährung|interruption of limitation of actions|interruption de la prescription|sospensione della prescrizione
Ausschreibung|alert|signalement|segnalazione
Observation|Überwachung|surveillance|observation|filature|osservazione
die Auslieferung bewilligen|authorise extradition|autoriser l'extradition|autorizzare l'estradizione
Cannabis|cannabis
Rauschgiftdetektionsmethode|drug-detection method|méthode de détection de drogue|metodo di ricerca della droga
legaler Verkehr mit Suchtstoffen und psychotropen Stoffen|legaler Handel mit Suchtstoffen und psychotropen Substanzen|legal trade in narcotic drugs and psychotropic substances|commerce légal de stupéfiants et substances psychotropes|commercio legale di stupefacenti e di sostanze psicotrope
ärztliche Behandlung|medical treatment|traitement médical|terapia medica
beglaubigte Bescheinigung|authenticated certificate|certificat authentifié|certificato autenticato da un'autorità competente
Aliasname|alias|nome detto
nationaler Teil des Schengener Informationssystems|nationaler Teil des SIS|national section of the Schengen Information System|partie nationale du Système d'Information Schengen|partie nationale du SIS|sezione nazionale del Sistema d'informazione Schengen|sezione nazionale del SIS
personenbezogener Hinweis "bewaffnet"|information that the person concerned is armed|indication que la personne concernée est armée|indicazione che le persone in questione sono armate
personenbezogener Hinweis "gewalttätig"|information that the person concerned is violent|indication que la personne concernée est violente|indicazione che le persone in questione sono violente
SIS|Schengener Informationssystem|Schengen Information System|Système d'information Schengen|Système d'Information Schengen|Sistema d'informazione Schengen|Sistema d'informazione di Schengen|Sistem d'infurmaziun da Schengen
SIRENE-Netz|SIRENE network|réseau SIRENE|Rete SIRENE
Einrichtung des Schengener Informationssystems|establishment of the Schengen Information System|création du Système d'Information Schengen|istituzione del Sistema d'informazione Schengen
Schadenersatz|amount paid in damages|réparation|riparazione
Speicherkontrolle|storage control|contrôle de l'intégration|controllo dell'inserimento|controllo di memoria
Zugangskontrolle|equipment access control|contrôle à l'entrée des installations|controllo all'ingresso delle istallazioni
Übermittlungskontrolle|communication control|contrôle de la transmission|controllo della trasmissione
Datensicherung|security of data|sécurité des données|sicurezza dei dati
datenschutzrechtliche Bestimmungen|provisions on the protection of personal data|dispositions en matière de protection des données|ricezione dei dati personali
Aufnahme von Daten|inclusion of data|intégration de données|inserimento dei dati
Empfang personenbezogener Daten|receipt of personal data|réception de données à caractère personnel|ricezione dei dati personali
nationale Ausschreibungsliste|national list of alerts|liste de signalement nationale|liste nationale de signalement|elenco nazionale delle persone segnalate
Verzeichnis der Visa|registre des visas|registrazione del visto
Entsorgungsstandard|waste disposal standard|norme d'élimination|norma di smaltimento
digitales Bündelfunksystem|digital trunk radio system|système radio numérique à ressources partagées|sistema di collegamento radio digitale
digitales Funksystem|digital radio system|système radio numérique|sistema di radiocomunicazione digitale
Zivilkleidung|civilian clothes|tenue civile|abiti civili|abiti borghesi
Liste der meldepflichtigen Feuerwaffen|Liste der meldepflichtigen Schusswaffen|list of firearms subject to declaration|liste des armes à feu soumises à déclaration|elenco delle armi da fuoco soggette a dichiarazione
Liste der erlaubnispflichtigen Feuerwaffen|Liste der erlaubnispflichtigen Schusswaffen|list of firearms subject to authorisation|liste des armes à feu soumises à autorisation|elenco delle armi da fuoco soggette a autorizzazione
Liste der verbotenen Feuerwaffen und Munition|Liste der verbotenen Schusswaffen und Munition|list of prohibited firearms and ammunition|liste des armes à feu et munitions prohibées|elenco delle armi da fuoco e munizioni proibite
erlaubnispflichtige Feuerwaffe|erlaubnispflichtige Waffe|genehmigungspflichtige Schusswaffe|firearm subject to authorisation|arme à feu soumise à autorisation|arme soumise à autorisation|arma da fuoco soggetta ad autorizzazione
Serien-Nr.|Herstellungsnummer der Feuerwaffe|Herstellungs-Nr.|Seriennummer der Schusswaffe|Identifizierungsnummer der Schusswaffe|manufacturer's number of the firearm|numéro de fabrication de l'arme à feu|numero di fabbricazione dell'arma da fuoco
meldepflichtige Feuerwaffe|meldepflichtige Waffe|meldepflichtige Schusswaffe|firearm subject to declaration|arme à feu soumise à déclaration|arme soumise à déclaration|arma soggetta ad autorizzazione
verbotene Feuerwaffe|verbotene Waffe|prohibited firearm|arme à feu prohibée|arme prohibée|arma proibita
für verbotene oder erlaubnispflichtige Feuerwaffen bestimmte Munition|für verbotene oder erlaubnispflichtige Schusswaffen bestimmte Munition|ammunition intended for prohibited arms or arms subject to authorisation|munition destinée à des armes prohibées ou soumises à autorisation|munizione destinata ad armi proibite o soggette ad autorizzazione
Prüfzeichen einer offiziellen Dienststelle|Prüfzeichen einer amtlichen Dienststelle|stamp of an official body|poinçon d'un organisme officiel|punzone di un organismo ufficiale
Erlaubnis zum Erwerb und Besitz einer Feuerwaffe|Genehmigung zum Erwerb und Besitz einer Schusswaffe|Bewilligung zum Erwerb und Besitz einer Schusswaffe|authorisation to acquire and to possess a firearm|autorisation d'acquisition et de détention d'une arme à feu|autorizzazione di acquisizione e di detenzione di un'arma da fuoco
Person, die eine Gefahr für die öffentliche Sicherheit oder Ordnung darstellt|person who might be a danger to public policy or public security|individu dangereux pour la sécurité ou l'ordre public|interessato pericoloso per la sicurezza e l'ordine pubblico
angeführter Grund|reason given|motif invoqué|motivo addotto
Hersteller von erlaubnispflichtigen Feuerwaffen|Hersteller von genehmigungspflichtigen Schusswaffen|manufacturer of firearms subject to authorisation|personne qui fabrique des armes à feu soumises à autorisation|persona che fabbrica armi da fuoco soggette ad autorizzazione
Händler von erlaubnispflichtigen Feuerwaffen|Händler von genehmigungspflichtigen Schusswaffen|dealer in firearms subject to authorisation|personne qui fait le commerce des armes à feu soumises à autorisation|persona che fa commercio di armi da fuoco soggette ad autorizzazione
Meldepflicht|declaration requirement|obligation de déclaration|obbligo di dichiarazione
Marke des Herstellers|Kennzeichnung der Feuerwaffe|Kennzeichnung der Schusswaffe|manufacturer's mark|marque du fabricant|marque apposée sur l'arme à feu|marchio apposto sull'arma da fuoco
Herkunftsstaat|country of origin|pays de provenance|pays d'origine|paese di provenienza
abgelaufenes Reisedokument|document that has expired|document de voyage périmé|documento di viaggio scaduto
Genehmigung, die als Sichtvermerk gilt|authorisation valid as a visa|autorisation tenant lieu de visa|autorizzazione sostitutiva del visto
Drittausländer, der nicht sämtliche vorgesehenen Einreisevoraussetzungen erfüllt|alien who does not fulfil all the entry conditions|étranger qui ne remplit pas l'ensemble des conditions d'entrée|straniero che non soddisfa le condizioni di ingresso
Gültigkeit eines Sichtvermerks|validity of a visa|validité d'un visa|validità di un visto
räumliche Beschränkung des Sichtvermerks|limiting the territorial validity of a visa|limitation de la validité territoriale d'un visa|limitazione della validità territoriale dei visti
Voraussetzungen für den Reiseverkehr von Drittausländern|conditions governing the movement of aliens|conditions de circulation des étrangers|condizioni di circolazione degli stranieri
Prüfung eines Sichtvermerksantrags|examination of a visa application|examen d'une demande de visa|esame di una domanda di visto
EEA|Einheitliche Europäische Akte|SEA|Single European Act|AUE|Acte unique européen|Atto unico europeo
Inhaber eines Dienstpasses|titulaire d'un passeport de service|titolare di un passaporto di servizio
Ausbreitung von Schadorganismen|propagation d'organismes nuisibles|propagazione di organismi nocivi
Empfehlung R (87) 15 des Ministerausschusses des Europarates über die Nutzung personenbezogener Daten im Polizeibereich vom 17.  September 1987|Recommendation No R (87) 15 of 17 September 1987 of the Committee of Ministers of the Council of Europe regulating the use of personal data in the police sector|Recommandation R (87) 15 du 17 septembre 1987 du Comité des Ministres du Conseil de l'Europe visant à réglementer l'utilisation des données à caractère personnel dans le secteur de la police|Raccomandazione R (87) 15 del 17 settembre del comitato dei Ministri del Consiglio d'Europa tendente a regolare l'uso dei dati di natura personale nel settore della polizia
SIRENE|Anträge auf Zusatzinformationen bei der nationalen Eingangsstelle|Supplementary Information Request at the National Entry|informations supplémentaires requises à l'entrée nationale|informazioni supplementari richieste all'atto dell'ingresso nel territorio nazionale
ausgehende Ausschreibung|signalement sortant|segnalazione in uscita
eingehende Ausschreibung|signalement entrant|segnalazione in entrata
Zusatzinformation|information supplémentaire|informazione supplementare
Kennzeichnung|indicateur de validité|indicatore di validità
Datum der Ausstellung|Ausstellungsdatum|date of issue|date de délivrance|data di rilascio
Management-Einheit|Managementeinheit|Management Unit|Unité de gestion|Unità di gestione
SDÜ|Schengener Durchführungsübereinkommen|Convention implementing the Schengen Agreement|CAS|Convention d'application de l'Accord de Schengen|Convenzione di applicazione dell’Accordo di Schengen|CAAS|Convenziun d'applicaziun da la Cunvegna da Schengen
Europäisches Auslieferungsübereinkommen vom 13. Dezember 1957|European Convention on Extradition of 13 September 1957|Convention européenne d'extradition du 13 décembre 1957|Convenzione europea di estradizione del 13 dicembre 1957|Convenziun europeica d'extradiziun dals 13 da december 1957
Benelux-Übereinkommen über Auslieferung und Rechtshilfe in Strafsachen|Benelux Treaty concerning Extradition and Mutual Assistance in Criminal Matters|Benelux Treaty on Extradition and Mutual Assistance in Criminal Matters|Traité Benelux d'extradition et d'entraide judiciaire en matière pénale|Trattato Benelux sull'estradizione e la mutua assistenza giudiziaria in materia penale
Dublin-Besitzstand|Dublin Acquis|Acquis "Dublin"|Acquis Dublino
Protokoll zur Einbeziehung des Schengen-Besitzstands in den Rahmen der Europäischen Union|Protocol integrating the Schengen Acquis into the framework of the European Union|Protocole intégrant l'acquis de Schengen dans le cadre de l'Union européenne|Protocollo sull'integrazione dell'acquis di Schengen nell'ambito dell'Unione europea
Rückübernahmeübereinkommen|Rückübernahmeabkommen|readmission agreement|accord de réadmission|accordo di riammissione
Schengen-Abkommen|Schengener Abkommen|Schengen Agreement|Accord de Schengen|Accordo di Schengen|Cunvegna da Schengen
Schengen-Besitzstand|Schengen Acquis|Acquis de Schengen|Acquis di Schengen
Schengener Durchführungsübereinkommen|Übereinkommen zur Durchführung des Übereinkommens von Schengen vom 14. Juni 1985|Durchführungsübereinkommen|Convention implementing the Schengen Agreement|Schengen Convention|Convention d'application de Schengen|Convention d'application de l'Accord de Schengen|Convention d'application de l'accord de Schengen du 14 juin 1985|Convention de Schengen|Convenzione di applicazione dell'Accordo di Schengen|Convenzione di Schengen|Convenzione del 19 giugno 1990
Übereinkommen des Europarates vom 21. März 1983 über die Überstellung verurteilter Personen|Council of Europe Convention on the Transfer of Sentenced Persons of 21 March 1983|Convention du Conseil de l'Europe du 21 mars 1983 sur le transfèrement des personnes condamnées entre les Parties Contractantes qui sont Parties à ladite Convention|Convenzione del Consiglio d'Europa del 21 marzo 1983 sul trasferimento delle persone condannate
Rechtakt der Europäischen Gemeinschaften|Community act|acte communautaire|atto comunitario
Beitrittsübereinkommen|Accession Agreement|accord d'adhésion|accordo di adesione
Einheitsübereinkommen von 1961 über die Betäubungsmittel|Einzige Suchtgiftkonvention 1961|Single Convention on Narcotic Drugs of 1961|Convention Unique sur les stupéfiants de 1961|Convenzione unica sugli stupefacenti del 1961
Ratifikationsurkunde|Ratifizierungsurkunde|instrument of ratification|instrument de ratification|strumento di ratifica
Beitrittsübereinkommen|accord d'adhésion|Accordo di adesione
Abbau der Kontrollen an den gemeinsamen Grenzen|abolition of checks at the common borders|suppression des contrôles aux frontières communes|eliminazione dei controlli alle frontiere comuni
Besenklausel|catch-all clause|clause-balai|clausola pigliatutto
Flüchtlingsstatus|status of refugees|statut des réfugiés|status dei rifugiati
Kompetenz|competence|compétence|competenza
Verbot der Doppelbestrafung|ne bis in idem principle|principe ne bis in idem|principio ne bis in idem|doppia punizione
gemeinsame Visapolitik|gemeinsame Visumpolitik|common visa policy|politique commune en matière de visas|politica comune in materia di visti
Unfallopfer|accident victim|victime d'accident|vittima di incidenti
diplomatische Vertretung|diplomatic authority|autorité diplomatique|autorità diplomatica
auf dem Seeweg|by sea|par voie maritime|per via marittima
auf dem Landweg|by land|par voie terrestre|per via terrestre
Annahme-Urkunde|instrument of acceptance|instrument d'acceptation|strumento di accettazione
Genehmigungsurkunde|instrument of approval|instrument d'approbation|strumento di approvazione
NZB|nationales Zentralbüro der Internationalen Kriminalpolizeilichen Organisation|nationales Zentralbüro|NCB|national central bureau of the International Criminal Police Organisation|national central bureau|BCN|bureau central national de l'Organisation Internationale de Police Criminelle|bureau central national|UCN|ufficio centrale nazionale dell'Organizzazione internazionale di polizia criminale|ufficio centrale nazionale
vorläufige Festnahme|provisional arrest|arrestation provisoire|arresto provvisorio
Auslandsvertretung|representation abroad|diplomatic mission or consular post|diplomatic and consular representation|représentation étrangère|représentation diplomatique ou consulaire|poste diplomatique et consulaire|rappresentanza
ausschreibende Vertragspartei|Contracting Party issuing the alert|Partie Contractante signalante|Parte contraente che ha effettuato la segnalazione
Drittland|third country|pays tiers|paese terzo
Durchreisestaat|Contracting Party of transit|transit Contracting Party|Partie Contractante de transit|pays de transit|Parte contraente di transito
empfangende Vertragspartei|recipient Contracting Party|Partie Contractante destinataire|Parte contraente destinataria
entsendende Vertragspartei|seconding Contracting Party|Partie Contractante d'origine|Parte contraente di origine
erster Bestimmungsstaat|first Contracting Party of destination|Partie Contractante de première destination|Parte contraente di prima destinazione
ersuchende Behörde|requesting Authority|autorité requérante|autorità richiedente
ersuchende Vertragspartei|requesting Contracting Party|Partie Contractante requérante|Parte contraente richiedente
ersuchte Behörde|requested Authority|autorité requise|autorità richiesta
ersuchte Vertragspartei|requested Contracting Party|Partie Contractante requise|Parte contraente richiesta
GK|gemeinsame Kontrollinstanz|joint supervisory authority|ACC|autorité de contrôle commune|autorità di controllo comune
Grenzkontrollbehörde|border authorities|autorité chargée des contrôles à la frontière|servizio addetto ai controlli di frontiera
Grenzüberwachungsbehörde|border surveillance authorities|autorité de surveillance de la frontière|autorità di sorveglianza della frontiera
nationale Kontrollinstanz|national supervisory authority|autorité nationale de contrôle|autorité de contrôle nationale|autorità nazionale di controllo|autorità di controllo nazionale
Schengen-Exekutivausschuss|Schengen Executive Committee|Comité exécutif Schengen|Comitato esecutivo Schengen
Schengen-Sekretariat|Schengen Secretariat|Secrétariat Schengen|Segretariato Schengen
Schengen-Staat|Schengen State|Etat Schengen|Stato Schengen
Ständiger Ausschuss Schengener Durchführungsübereinkommen|Standing Committee on the evaluation and implementation of Schengen|Commission permanente d'évaluation et d'application de Schengen|Commissione permanente di valutazione e di applicazione di Schengen
Vertragspartei der ersten Einreise|Contracting Party of first entry|Partie Contractante de première entrée|Parte contraente in cui avviene il primo ingresso
Zentrale Gruppe|Central Group|Groupe central|Gruppo centrale
zentrale Stelle|central body|instance centrale|organo centrale
Vertragspartei, die den Sichtvermerk ausgestellt hat|Contracting Party which issued the visa|Partie Contractante qui a délivré le visa|Parte contraente che ha rilasciato il visto
Kontrollinstanz|supervisory authority|autorité de contrôle|autorità di controllo
empfangende Vertragspartei|recipient Contracting Party|Partie Contractante destinataire|Parte contraente destinataria
übermittelnde Vertragspartei|Contracting Party communicating data|Partie Contractante qui transmet les données|Parte contraente che trasmette i dati
Vertragspartei, an die das Asylbegehren gerichtet worden ist|Contracting Party with whom the application for asylum was lodged|Partie Contractante auprès de laquelle la demande d'asile a été introduite|Parte contraente presso la quale la domanda di asilo è stata presentata
Beförderungsunternehmer|carrier|transporteur|vettore
Drittausländer|alien|ressortissant de pays tiers|étranger|straniero
Informant|informer|informateur|informatore
nacheilender Beamter|pursuing officer|agent poursuivant|agente impegnato nell'inseguimento
observierender Beamter|officer carrying out the surveillance|agent observateur|agente addetto all'osservazione
sichtvermerksfreier Drittausländer|alien not subject to a visa requirement|étranger non soumis à l'obligation de visa|étranger dispensé de l'obligation du visa|straniero non soggetto all'obbligo del visto
VP|V-Person|Vertrauensperson|informer|indicateur|confidente
Verbindungsbeamter|liaison officer|fonctionnaire de liaison|funzionario di collegamento
Verfolgter|wanted person|personne réclamée|persona ricercata|persona perseguita
Drittausländer, dessen Asylbegehren endgültig negativ abgeschlossen ist|alien whose application for asylum has been definitively rejected|étranger dont la demande d'asile a été définitivement rejetée|straniero la cui domanda è stata definitivamente respinta
Geschädigter|injured party|personne lésée|persona lesa
Verwahrer|depositary|dépositaire|depositario
Fall der Notwehr|legitimate self-defence|cas de légitime défense|caso di legittima difesa
Hoheitsgebiet der Vertragspartei, die den Sichtvermerk ausgestellt hat|territory of the Contracting Party which issued the visa|territoire de la Partie Contractante qui a délivré le visa|territorio della Parte contraente che ha rilasciato il visto
gefährliche Abfälle|hazardous waste|déchets dangereux|rifiuti pericolosi
Aussengrenze|external border|frontière extérieure|frontiera esterna
gemeinsame Grenze|common border|frontière commune|frontiera comune
Grenzübergangsstelle|border crossing point|point de passage frontalier|valico di frontiera
kleiner Grenzverkehr|local border traffic|petit trafic frontalier|piccolo traffico di frontiera
Raum ohne Binnengrenzen|area without internal frontiers|espace sans frontières intérieures|spazio senza frontiere interne
Binnenflug|internal flight|vol intérieur|Volo interno|traffico interno
Binnenschiffsverkehr|inland waterway traffic|trafic fluvial aux frontières communes|transport par voies navigables intérieures|traffico fluviale alle frontiere comuni
Rettungsflug|vol de sauvetage|volo di salvataggio
Schengener Gemeinschaftsgebiet|Gebiet der Schengener Staaten|Schengen|Schengengebiet|Schengen territory|territoire Schengen|espace Schengen|territorio Schengen
Asylbegehrender|Asylbewerber|Asylwerber|asylum seeker|demandeur d'asile|richiedente l'asilo
Behandlung eines Asylbegehrens|Behandlung eines Asylantrags|processing applications for asylum|traitement d'une demande d'asile|esame di una domanda di asilo
Grenzverkehr|border traffic|trafic frontalier|traffico frontaliero|traffico di confine
grenzüberschreitender Reiseverkehr|cross-border movements of travellers|circulation transfrontalière des voyageurs|circolazione transfrontiera dei viaggiatori
Verkehrsbeschränkung|restriction à la circulation|limitazione al traffico
Verkehrshindernis|obstacle à la circulation|ostacolo al traffico
Wiederausfuhr|re-export|réexportation|riesportazione
auslieferungsfähige Straftat|extraditable criminal offence|fait punissable pouvant donner lieu à extradition|reato che può dare luogo ad estradizione
Straftat|strafbare Handlung|Delikt|criminal offence|offence|fait punissable|fatto punibile|reato
Besitz von Feuerwaffen|Besitz von Schusswaffen|possession of firearms|détention d'armes à feu|detenzione di armi da fuoco
Erwerb von Feuerwaffen|Erwerb von Schusswaffen|acquisition of firearms|acquisition d'armes à feu|acquisizione di armi da fuoco
illegaler Waffenhandel|Waffenschiebung|illegal trade in firearms|trafic illicite d'armes|traffico illecito di armi
Vertrieb von Feuerwaffen|trade in firearms|commerce d'armes à feu|commercio di armi da fuoco
Überlassen von Feuerwaffen|handing over of firearms|remise d'armes à feu|consegna di armi da fuoco
Betäubungsmittel|Suchtstoff|Droge|Rauschgift|Suchtmittel|narcotic substance|narcotic drug|drug|stupéfiants|drogue|stupefacenti|prodotti stupefacenti
Drogentourismus|drug tourism|tourisme de la drogue|turismo della droga
illegaler Drogenfluss|illicit drug flows|flux illicite de stupéfiants|flusso illecito di stupefacenti
unerlaubter Verkehr mit Betäubungsmitteln|unerlaubter Handel mit Betäubungsmitteln|unerlaubter Handel mit Suchtmitteln|trafficking in narcotic drugs and psychotropic substances|trafic de stupéfiants et de substances psychotropes|traffico illecito di stupefacenti e sostanze psicotrope
Entführung|kidnapping|abduction|enlèvement|rapt|sequestro di persona|rapimento
Entführung von Minderjährigen|abduction of minors|enlèvement de mineurs|rapimento di minori
Erpressung|extortion|extorsion|estorsione
Geiselnahme|hostage taking|prise d'otage|presa in ostaggio
illegale Einwanderung|illegale Zuwanderung|illegal immigration|immigration clandestine|immigrazione illegale|immigrazione clandestina
Menschenhandel|trafficking in human beings|trafic d'êtres humains|tratta di persone
schwerer Diebstahl|aggravated burglary|aggravated theft|vol aggravé|furto aggravato
Terrorismus|terrorism|terrorisme|terrorismo
Totschlag|manslaughter|meurtre|omicidio|omicidio passionale
unerlaubter Verkehr mit giftigen und schädlichen Abfällen|illicit transportation of toxic and hazardous waste|transport illicite de déchets toxiques et nuisibles|trasporto illecito di rifiuti tossici e nocivi|traffico illecito
unerlaubtes Entfernen|failure to stop|délit de fuite|reato di fuga
Vergewaltigung|rape|viol|stupro|violenza carnale
Vernichtung durch Sprengstoffe|wilful damage through the use of explosives|destruction par explosifs|distruzione mediante esplosivi
vorsätzliche Brandstiftung|arson|incendie volontaire|incendio doloso|incendio intenzionale
Falschmünzerei|forgery of money|counterfeiting currency|faux monnayage|fausse monnaie|falso nummario|falsificazione delle monete
Einschleppung von Schadorganismen|introduction of harmful organisms|introduction d'organismes nuisibles|introduzione di organismi nocivi
Sichtvermerk für einen kurzfristigen Aufenthalt|short-stay visa|visa pour un séjour de courte durée|visto per un soggiorno di breve durata
Sichtvermerksregelung|arrangements for visas|régime des visas|regime dei visti
gemeinsame Voraussetzungen und Kriterien|common conditions and criteria|conditions et critères communs|condizioni e criteri comuni
für eine oder mehrere Einreisen gültiger Sichtvermerk|travel visa valid for one or more entries|visa de voyage valable pour une ou plusieurs entrées|visto di viaggio valido per uno o più ingressi
konsularische Vertretung|consular authorities|autorité consulaire|rappresentanza consolare
Kriterium zur Bestimmung des Hauptreiseziels|criterion for determining the main destination|critère de détermination de la destination principale|criterio per determinare la destinazione principale
Hauptreiseziel|main destination|destination principale|destinazione principale
sichtvermerksfähiges Reisedokument|travel document to which a visa may be affixed|document de voyage pouvant être revêtu d'un visa|documento di viaggio che può essere munito di un visto
Verlängerung eines Sichtvermerks|extension of a visa|prolongation d'un visa|proroga del visto
Modalitäten der räumlichen Beschränkung des Sichtvermerks|procedures for limiting the territorial validity of visas|modalité de limitation de la validité territoriale des visas|modalità di limitazione della validità territoriale dei visti
gemeinsame Liste von zur Einreiseverweigerung ausgeschriebenen Drittausländern|common list of aliens for whom an alert has been issued for the purposes of refusing entry|liste commune des étrangers signalés aux fins de non-admission|elenco comune degli stranieri segnalati ai fini della non ammissione
Sichtvermerk für einen längerfristigen Aufenthalt|long-stay visa|visa pour un séjour de longue durée|visto per un soggiorno di lunga durata
die Einreisevoraussetzungen erfüllen|die Voraussetzungen für die Einreise erfüllen|fulfil the entry conditions|remplir les conditions d'entrée|soddisfare le condizioni di ingresso
Drittausländer, der Inhaber eines von einer der Vertragsparteien ausgestellten Sichtvermerks ist|aliens who hold valid residence permits issued by one of the Contracting Parties|étranger titulaire d'un visa délivré par une des Parties Contractantes|straniero titolare di un visto rilasciato da una delle Parti contraenti
Anbringung eines Stempels|affixing of a stamp|apposition d'un cachet|apposizione di un timbro
Schengener Visumetikett|Schengen Visummarke|Schengen visa sticker|vignette visa Schengen|vignetta visto Schengen
Kontrollkabine|customs shed|aubette de contrôle|cabina di controllo
Phase der Abstimmung|phase for consultation|phase de concertation|fase di concertazione
Planung|planning|planification|pianificazione
Vorbereitungsabschnitt|preparatory phase|étape de préparation|tappa di preparazione
Nachbarstaat|neighbouring State|Etat limitrophe|Stato limitrofo
technische Vorkehrung|technical adjustments|adaptation technique|misura tecnica
Behinderung des Verkehrsflusses|Verkehrshindernis|obstacles to traffic|obstacle à la circulation|ostacolo al traffico|ostacolo fisico alla circolazione
durch ein Hoheitsgebiet durchreisen|transit through national territory|transiter par un territoire national|transitare attraverso il territorio nazionale
Tabelle zur Vertretungsregelung|table on representation|tableau de représentation|tabella relativa alla rappresentanza
Sorgerecht|right of custody|droit de garde|affidamento
Fährschiff|ferry|car ferry|ferry-boat|train ferry|transbordeur|navire transbordeur|traghetto
Fremdenpolizei|aliens police|police des étrangers|polizia degli stranieri
technischer Besitzstand Schengens|technical Schengen acquis|acquis technique de Schengen|Acquis di Schengen di carattere tecnico
Einschreiten|action|intervention|intervento
Gemeinsames Handbuch|Common Manual|Manuel commun|Manuale comune
VFT|Visum für den Flughafentransit|Flughafentransitvisum|ATV|airport transit visa|VTA|visa de transit aéroportuaire|visto di transito aeroportuale|visum da transit d'eroport
Visum für die mehrfache Einreise|Mehrfachvisum|multiple entry visa|visa à entrées multiples|visto multiplo|visti per più ingressi
Sammelvisum|group visa|visa collectif|visto collettivo
Visum für den längerfristigen Aufenthalt|long-stay visa|visa de long séjour|visto per soggiorni di lunga durata
zu erhebende Gebühr|einzuhebende Gebühr|fees to be charged|droit à percevoir|diritto da riscuotere
Honorarkonsul|honorary consul|consul honoraire|console onorario
grenzpolizeiliche Kontrolle|checks at the border|contrôle à la frontière|contrôles aux frontières|controllo di polizia di frontiera
Straßenübergang|road crossing point|point de passage routier|valico stradale
grenzüberschreitender Verkehr|cross-border traffic|trafic transfrontière|trafic transfrontalier|traffico transfrontaliero
Reederei|shipping company|armateur|compagnia marittima
Schiffsagent|shipping agency|agent maritime|agente marittimo
Garantieerklärung|guarantee|engagement de prise en charge|dichiarazione di garanzia|impegno di presa a carico
Schengen-Formular|Schengen form|formulaire Schengen|formulario Schengen
Gegenbeweis|réfutation de la preuve|prova contraria
Anmusterungsnachweis|Anheuerungsnachweis|embarkation card|carte d'embarquement|carta d'imbarco
Abmusterungsnachweis|Abheuerungsnachweis|disembarkation card|carte de débarquement|carta di sbarco
ausstellende Grenzdienststelle|issuing border post|poste-frontière de délivrance|ufficio di frontiera di rilascio
Seemann auf Durchreise|seaman in transit|marin en transit|marittimo in transito
Schifffahrt|merchant navy|navigation|marine marchande|navigazione
anmusternder Seemann|anheuernder Seemann|seaman who signs on a vessel|marin qui est enrôlé|marittimo in procinto di arruolarsi
abmusternder Seemann|abheuernder Seemann|seaman who leaves the service|marin qui quitte le service|marittimo in procinto di sbarcare per fine ingaggio
Meldeformular|information form|formulaire d'information|formulario informativo
visumpflichtiger Seemann auf der Durchreise|seaman in transit subject to visa requirements|marin en transit soumis à l'obligation de visa|marittimo in transito soggetto all'obbligo del visto
mit dem Grenzschutz betraute Behörde|für den Grenzschutz zuständige Behörde|border control authority|autorité chargée de la surveillance des frontières|autorità preposta alla sorveglianza delle frontiere
Sammelpass|collective passport|passeport collectif|passaporto collettivo
Reisedokument für Staatenlose|travel document for a stateless person|stateless person's travel document|document de voyage pour apatrides|documento di viaggio per apolidi
Passierschein|laissez-passer|lasciapassare
Kinderausweis|children's identity document|titre d'identité pour enfant|titolo d'identità per minore
Seemannsbuch|seaman's book|livret de marin|libretto per marittimi
Reisedokument für Flüchtlinge|refugee's travel document|titre de voyage pour réfugiés|titolo di viaggio per rifugiati
Reisedokument für Ausländer|alien's travel document|titre de voyage pour étrangers|titolo di viaggio per stranieri
Steuerungsgruppe SIS|SIS-Steuerungsgruppe|SIS Steering Committee|Comité d'orientation SIS|Comitato di orientamento SIS
Zeitgenehmigung|licence for a period of time|autorisation à temps|permesso a termine
Doppelkontrolle|duplicated check|double contrôle|duplice controllo
Nutzfahrzeug|commercial vehicles|véhicule utilitaire|veicolo utilitario
grüne Scheibe|green disc|disque vert|disco verde
Stichprobenkontrolle|spot checks|contrôle par sondage|controllo per sondaggio
sichtbares Zeichen|visual symbol|symbole optique|simbolo visibile
Fahrtgenehmigung|licence for a journey|autorisation au voyage|autorizzazione di viaggio|permesso di viaggio
Eisenbahntransport|rail transport|transport ferroviaire|trasporto ferroviario
Binnenschiffsverkehr|waterway traffic|trafic fluvial|traffico fluviale
Verbrauchsteuer|excise duties|droit d'accise|droits d'accises|accises|accise
Ausländerrecht|Fremdenrecht|law on aliens|droit des étrangers|diritto degli stranieri
Reisefreigrenzen|Zollfreigrenzen|duty-free allowances granted to travellers|franchise accordée aux voyageurs|franchigia accordata ai viaggiatori
Gemeinschaftsfreigrenzen|Community allowances|franchise communautaire|franchigia comunitaria
Grundsatz der Gegenseitigkeit|rule of reciprocity|principe de la réciprocité|principio di reciprocità
Beschränkung der Freimengen|limits on the duty-free allowances|limitation des franchises|limite di franchigia
Austausch der Daten|Datenaustausch|exchange of data|échange de données|scambio di dati
Erhebung der Mehrwertsteuer|Einhebung der Mehrwertsteuer|collection of VAT|perception de la TVA|riscossione dell'IVA
Freigrenze für Kraftstoff|Freigrenze für Treibstoff|duty-free allowance for fuel|franchise pour le carburant|franchigia per il carburante
Einheitsdokument|single document|document unique|documento unico
Auslegung eines Übereinkommens|interpretation of a convention|interprétation d'une Convention|interpretazione della Convenzione
Grenzbewohner|frontier-zone resident|frontalier|frontaliere
Ladung|summons|notification|notificazione
Binnengrenze|internal border|frontière intérieure|frontiera interna
Gefahrenabwehr|prevention of threats|prévention de menaces|prevenzione di minacce
Blankodokument|blank official document|blank document|document vierge|documento intatto
Registriergeld|suspect banknotes|billets enregistrés|banconota registrata
Exekutivausschuss|Executive Committee|Comité exécutif|comitato esecutivo
Zweckentfremdung|misuse|détournement de finalité|sviamento di finalità
flexibles Verfahren|flexible procedure|procédure souple|procedura flessibile
zur Einreiseverweigerung ausgeschriebener Drittausländer|alien for whom an alert has been issued for the purposes of refusing entry|étranger signalé aux fins de non-admission|straniero segnalato ai fini della non ammissione
Sanktion|penalty|sanction|sanzione
Vergnügungsschifffahrt|pleasure boating|navigation de plaisance|navigazione da diporto
Küstenfischerei|coastal fishing|pêche côtière|pesca costiera
Seeverkehr|maritime traffic|trafic maritime|traffico marittimo
Passkontrolle|passport control|contrôle des passeports|controllo dei passaporti
einem Ersuchen stattgeben|grant a request|accéder à une requête|accedere a una richiesta
Einfuhrzölle|import duties|droits d'entrée|dazi doganali
Landgrenze|land border|frontière terrestre|frontiera terrestre
öffentlich nicht zugängliches Grundstück|place not accessible to the public|lieu non accessible au public|luogo non accessibile al pubblico
Geschädigter|victim|victime|vittima
beherbergter Ausländer|accommodated alien|étranger hébergé|straniero alloggiato
Leiter des Polizeidienstes|head of the police department|chef du service de police|capo del servizio di polizia
Verfahren in Gnadensachen|clemency proceeding|procédure de grâce|procedura di grazia
Aufenthalt|residence|séjour|soggiorno
Einreise|entry|entrée|ingresso
Erledigung|admissibility|recevabilité|ricevibilità
Voraussetzungen für den Aufenthalt|conditions governing residence|conditions de séjour|condizioni di soggiorno
Ausreise|exit|sortie|uscita
Voraussetzungen für die Einreise|conditions d'entrée|condizioni d'ingresso
Voraussetzung für die Arbeitsaufnahme|conditions governing work|conditions de travail|condizioni di lavoro
Verschluss|breach-closing mechanism|mécanisme de fermeture|otturatore
Patronenlager|Magazin|magazine|magasin|chambre|caricatore
Lauf|barrel|canon|canna
Munition mit Brandsätzen|ammunition with incendiary projectiles|munition à balles incendiaires|munizione con pallottole incendiarie|munizione a pallottole incendiarie
Pistolen- und Revolvermunition mit Dumdum-Geschossen oder Hohlspitzgeschossen|ammunition for pistols and revolvers with dumdum or hollow-pointed projectiles|munition pour les pistolets et revolvers avec des projectiles dum-dum ou à pointes creuses|munizione per pistole e revolver con pallottole dum-dum o a punta cava
halbautomatische Kurz-Feuerwaffe|halbautomatische Kurz-Schusswaffe|semi-automatic short firearm|arme à feu courte semi-automatique|arma da fuoco corta semiautomatica
kurze Repetier-Feuerwaffe|kurze Repetierwaffe|repeating short firearms|arme à feu courte à répétition|arma da fuoco corta a ripetizione
kurze Einzellader-Feuerwaffe mit Zentralfeuerzündung|kurze Einzelladerwaffe mit Zentralfeuerzündung|single-shot short firearms with centrefire percussion|arme à feu courte à un coup, à percussion centrale|arma da fuoco corta ad un colpo, a percussione centrale
kurze Einzellader-Feuerwaffe mit Randfeuerzündung mit einer Gesamtlänge von weniger als 28 cm|kurze Einzelladerwaffe mit Randfeuerzündung mit einer Gesamtlänge von weniger als 28 cm|single-shot short firearms with rimfire percussion, with an overall length of less than 28 cm|arme à feu courte à un coup, à percussion annulaire d'une longueur totale inférieure à 28 centimètres|arma da fuoco corta ad un colpo a percussione anulare, di lunghezza totale inferiore a 28 cm
lange Repetier-Feuerwaffe|repeating long firearm|arme à feu longue à répétition|arma da fuoco lunga a ripetizione ordinaria
Reizstoffwaffe|arm used to fire non-lethal incapacitants|arm containing irritants|arme lacrymogène|arma lacrimogena
Signalwaffe|arm used as an alarm|arme d'alarme|arma di allarme
Patrone mit Metallhülse|metal-case cartridge|cartouche à étui métallique|cartuccia a bossolo metallico
Reproduktion von Waffen|Nachbau von Waffen|reproduction of arms|reproduction d'armes|riproduzione di armi
Meldung|declaration|déclaration|dichiarazione
Anmeldebestätigung|declaration certificate|certificat de déclaration|certificato di dichiarazione
Liste der verbotenen, erlaubnispflichtigen und meldepflichtigen Feuerwaffen|Liste der verbotenen, erlaubnispflichtigen und meldepflichtigen Schusswaffen|list of firearms which are prohibited, subject to authorisation or subject to declaration|liste des armes prohibées, soumises à autorisation et à déclaration|elenco delle armi da fuoco proibite, soggette ad autorizzazione e a dichiarazione
Einzelhändler|firearms dealer|armurier détaillant|armaiolo commerciante
Privatperson|private individual|particulier|privato|persona privata
