Waffengebrauch|use of firearms|utilisation d'armes|uso di armi|diever d'armas
Leihwaffe|arme en prêt|arma in prestito|arma ad emprest
persönliche Waffe|personal weapon|individual weapon|arme personnelle|arma personale|arma persunala
Treibladung|propellant|propelling charge|charge propulsive|charge de propulsion|carica propulsiva|chargia propulsiva
ausserdienstliches Schiesswesen|Schiesswesen ausser Dienst|off-duty target practise|extra-service practise shooting|tir hors du service|tir hors service|tiro fuori del servizio|tiro fuori servizio|tir ordaifer il servetsch
Waffenhandelsbewilligung|licence to trade arms|patente de commerce d'armes|patente di commercio di armi|permissiun per il commerzi cun armas
Waffe|weapon|arme|arma
Druckluftwaffe|arme à air comprimé|arma ad aria compressa|arma ad aria cumprimida
Schleuder|Steinschleuder|sling|fronde|fionda|funda
Schweizer Armeetaschenmesser|Swiss army knife|couteau de l'armée suisse|coltello tascabile dell'esercito svizzero|cuntè da satg da l’armada svizra
militärisches Abschussgerät mit Sprengwirkung|lanceur militaire à effet explosif|ordigno militare per il lancio con effetto dirompente|apparat militar per sajettar cun effect explosiv
mit einer Feuerwaffe verwechselbare Waffe|arma confondibile con un'arma da fuoco|arma confundibla cun in'arma da fieu
besonders konstruierter Waffenbestandteil|composant d'arme spécialement conçu|parte di arma appositamente costruita|part d’arma construida spezialmain
besonders konstruierter Bestandteil von Waffenzubehör|composant d'accessoires d'armes spécialement conçu|parte appositamente costruita di accessori di armi|part d'accessoris d'armas construida spezialmain
Sicherheitsbeauftragter im Luftverkehr|Sicherheitsbeauftragte im Luftverkehr|Tiger|garde de sûreté dans l'aviation civile|tigre|guardia di sicurezza nell'aviazione civile|tiger|incumbensà per la segirezza en l'aviaziun civila
Waffenerwerbsschein|permis d'acquisition d'armes|permis d'achat d'armes|permesso di acquisto di armi|permissiun d'acquistar armas
Schusswaffenerwerb|Erwerb von Schusswaffen|acquisition d'armes à feu|acquisto di armi da fuoco|acquist d'armas da fieu
Erwerb von Munition|Munitionserwerb|acquisition of ammunition|acquisition de munition|acquisto di munizione|acquisizione di munizioni|acquist da muniziun
Schreckschusswaffe|arme d'alarme|arme d'avertissement|scacciacane|arma per segnalazione|arma d’alarm
Sportschütze|Sportschützin|marksman|tireur sportif|tiratore sportivo|tiradur da sport
Waffenbestandteil|composant d´arme|parte di arma|part d’arma
Munitionsbestandteil|élément de munition|elemento di munizione|element da muniziun
Wurfmesser|couteau à lancer|coltello da lancio|cuntè da trair
Nachtsichtzielgerät|dispositif de visée nocturne|dispositivo di puntamento notturno|apparat da mira da laser e da notg
Waffenhandel|commerce d'armes|commercio di armi|commerzi cun armas
Jagdbewilligung|permis de chasse|licenza di caccia|patenta da chatscha
Sportwaffe|arme de sport|arma da sport
Schützenverein|shooting club|gun club|riflemen's association|société de tir|società di tiro|societad da tir
Bogen|arc|arco|artg
Schaft|fût|fusto|lain dal schluppet
Kolben|butt|crosse|calcio|chaltgogn da schluppet
Abzug|trigger|détente|grilletto|tgiet
Armbrust|crossbow|arbalète|balestra|balester
Pfeilbogen|arc|arco|artg
Bajonett|bayonet|baïonnette|baionetta
Kugel|bullet|balle|biglia|balla
Pfeil|arrow|flèche|freccia|frizza|paliet
Bolzen|matras|dardo|paliet|frizza
Geschoss|Projektil|projectile|proiettile|projectil
Saite|corde|corda
CO2-Waffe|arme au CO2|arme à CO2|arma a CO2|arma con CO2|arma da CO2
Büchse|fusil à balle|carabine|fucile a canna rigata|carabina a canna rigata|schluppet d'ina channa|schluppet a channa cun spirala
Dekowaffe|arme de décoration|arma da decorazione|arma da decoraziun
Dolch|dagger|poignard|pugnale|stilet
einläufige Waffe|arme à un canon|arma a una canna|schluppet d'ina channa
doppelläufige Waffe|arme à deux canons|arma a doppia canna|arma a channa dubla
mehrläufige Waffe|arme à plusieurs canons|arma a più canne|arma a pliras channas
Einzellader|Einzelladerwaffe|Einzelladewaffe|single-shot firearm|arme à un coup|arma a colpo singolo|arma a chargia singula
Elektroschockgerät|appareil d'électrochocs|appareil à électrochocs|appareil produisant des électrochocs|apparecchio per elettroshock|apparecchio per elettrochoc|apparat d’electroschoc
Faustfeuerwaffe|small arms|handguns|arme à feu de poing|arma corta da fuoco|arma da fuoco da pugno|arma da fieu curta
Feuerwaffe|arme à feu|arma da fuoco|arma da fieu
Schrotflinte|Flinte|shot gun|shotgun|fusil à canon lisse|fusil à grenaille|fucile a canna liscia|flinta
Gewehr|rifle|fusil|fucile|schluppet
Gasdruckschusswaffe|arme à gaz comprimé|arma a gas|arma a gas cumprimì
glatter Lauf|Flintenlauf|canon lisse|canna liscia|channa glischa
gezogener Lauf|canon rayé|canna rigata|channa cun spirala
Zug|rayure|rigatura|rajada
Maschinenpistole|submachine gun|pistolet-mitrailleur|pistola mitragliatrice|mitraglietta|pistola-mitraglia
Gotcha-Waffe|Paint-Ball-Waffe|Paintball-Waffe|paintball gun|paintball marker|arme gotcha|arme à balle colorante|arme de paint-ball|paint-ball|arma Gotcha|arma paintball|arma da ballas da colur|arma da gotcha
Handfeuerwaffe|arme à feu à épauler|arma da fuoco portatile|arma da fieu da maun
Jagdwaffe|arme de chasse|arma da caccia|arma da chatscha
Kaliber|calibre|calibro|caliber
Karabiner|carbine|mousqueton|carabina
kurze Feuerwaffe|Kurzfeuerwaffe|Kurzwaffe|short firearm|arme à feu courte|arme courte|arma da fuoco a canna corta|arma da fuoco corta|arma a canna corta|arma da fieu curta
lange Feuerwaffe|Langwaffe|langläufige Waffe|long firearm|arme à feu longue|arme longue|arme à canon long|arma da fuoco a canna lunga|arma a canna lunga|arma da fuoco lunga|arma da fieu lunga
Mehrlader|Mehrladerwaffe|Mehrladewaffe|magazine rifle|arme à plusieurs coups|arma a più colpi|arma a plirs culps
Springmesser|couteau à ouverture automatique|couteau à cran d'arrêt|coltello a scatto|cuntè cun penna
Fallmesser|couteau à lame tombante|coltello a lama ripiegabile|cuntè a lama crudanta
Klappmesser|couteau pliant|couteau à lame escamotable|coltello a serramanico|cuntè plegabel
Munition|ammunition|munition|munizione|muniziun
Ordonnanzwaffe|service weapon|arme d'ordonnance|arma d'ordinanza|arma d'ordonanza
Patrone|round of ammunition|round|cartridge|cartouche|cartuccia|patrona
Patronenlager|cartridge chamber|chamber|twin cartridge breech|breech|chambre à cartouche|camera di scoppio|camera delle cartucce|chombra da patronas|cassa da la patrona
Pistole|pistol|pistolet|pistola
Revolver|revolver|rivoltella
Schalldämpfer|silencieux|silenziatore|surdina
Schlagring|knuckleduster|brass knuckles|coup de poing américain|tirapugni|rintg da pugnada
Schlagrute|baton|matraque à ressort|manganello|manganello flessibile|pertga
Wurfstern|Ninja-Stern|Shuriken|throwing star|ninja star|shuriken|star-shaped projectile|étoile à lancer|étoile Ninja|stella da lancio|stella da tiro|stella Ninja|Ninja|staila da trair
Schrot|grenaille|pallini|ballins
Schusswaffe|arme de tir|arma da tiro|arma da fieu
Seriefeuerwaffe|automatische Waffe|automatic firearm|arme à feu automatique|arme tirant par rafales|arma da fuoco per il tiro a raffica|arma da fuoco per il tiro a raffiche|arma per il tiro a raffiche|arma da fuoco automatica|arma automatica|arma da fieu a seria
Spielzeugwaffe|arme-jouet|arme factice|arma-giocattolo|arma-giugaret
Sprayprodukt zur Selbstverteidigung|Spray zur Selbstverteidigung|Abwehrspray|spray d'autodéfense|spray destinato all'autodifesa|spray di autodifesa|spray di difesa|spruzzatore per l'autodifesa|spray da defensiun
Uzi|UZI
Verschluss|bolt|dispositif de verrouillage|otturatore|serradira
Replika|réplique|replica
Waffentragbewilligung|permis de port d'armes|autorizzazione di porto di armi|permissiun per purtar in’arma
Waffenzubehör|accessoire d'armes|accessoire d'une arme|accessorio di armi|accessorio di un'arma|accessori d’armas|accessori d’ina arma
wesentlicher Waffenbestandteil|élément essentiel d'arme|parte essenziale di arma|part essenziala d’arma
Erwerb von Munitionsbestandteilen|acquisition d'éléments de munition|acquisto di elementi di munizione|acquist d’elements da muniziun
Besitz von Munition|possession de munition|possesso di munizione|possess da muniziun
Besitz von Munitionsbestandteilen|possession d'éléments de munition|possesso di elementi di munizione|possess d’elements da muniziun
gefährlicher Gegenstand|objet dangereux|oggetto pericoloso|object privlus
missbräuchliches Tragen von gefährlichen Gegenständen|missbräuchliches Tragen gefährlicher Gegenstände|port abusif d'objets dangereux|porto abusivo di oggetti pericolosi|purtar abusivamain objects privlus
missbräuchlich getragener gefährlicher Gegenstand|objet dangereux porté de manière abusive|oggetto pericoloso portato abusivamente|object privlus purtà abusivamain
antike Waffe|arme ancienne|arma antica
Stichwaffe|thrust weapon|stabbing weapon|arme perçante|arma da punta|arma da piz
Hiebwaffe|cutting weapon|arme tranchante|arma da taglio|arma da culpir
Hieb- und Stichwaffe|Blankwaffe|blanke Waffe|cut-and-thrust weapon|arme blanche|arma da taglio e da punta|arma bianca|arma da culpir e da piz
Waffenerwerb|Erwerb von Waffen|acquisition d'armes|acquisto di armi|acquist d’armas
Waffenbesitz|Besitz von Waffen|possession d'armes|possesso di armi|possess d’armas
Waffentragen|Tragen von Waffen|port d'armes|porto di armi
Schmetterlingsmesser|Schmetterlingsschwert|couteau papillon|coltello a farfalla|cuntè-tgiralla
Dolch mit symmetrischer Klinge|poignard à lame symétrique|pugnale a lama simmetrica|stilet cun loma simmetrica
Schlagstock|truncheon|matraque simple|matraque|bastone da combattimento|bastun da culpir
Messer|couteau|coltello|cuntè
Imitationswaffe|arme factice|imitazione di arma|arma d’imitaziun
Soft-Air-Waffe|arme soft air|arma soft air|arma da soft air
Laserzielgerät|dispositif de visée laser|laser di puntamento|laser|apparat da mira da laser
Granatwerfer|lance-grenade|lanciagranate|bittagranata
Schiessmaterial|matériel de tir|materiale esplosivo|material da tir
Taschenmesser|couteau de poche|coltello da tasca|coltello tascabile|cuntè da satg
militärisches Abschussgerät|lanceur militaire|ordigno militare per il lancio|apparat militar per sajettar
Schiessanlass|Schiessveranstaltung|manifestation de tir|manifestazione di tiro|manifestazione di una società di tiro|occurrenza da tir
behördlich zugelassener  Schiessanlass|manifestation de tir autorisée officiellement|manifestazione di tiro autorizzata ufficialmente|occurrenza da tir permessa uffizialmain
schweizerische Ordonnanz-Seriefeuerwaffe|Ordonnanz-Seriefeuerwaffe|arme à feu automatique d'ordonnance suisse|arme à feu automatique d'ordonnance|arma da fuoco di ordinanza svizzera|arma da fuoco di ordinanza|arma da fieu a seria svizra d’ordonanza|arma da fieu a seria d’ordonanza
Erwerb von wesentlichen Waffenbestandteilen|Erwerb eines wesentlichen Waffenbestandteils|acquisition d'éléments essentiels d'armes|acquisition d'un élément essentiel d'arme|acquisto di parti essenziali di armi|acquisto di una parte essenziale di arma|acquist da parts essenzialas d’armas|acquist d'ina part essenziala d’arma
Besitz von wesentlichen Waffenbestandteilen|Besitz eines wesentlichen Waffenbestandteils|possession d'éléments essentiels d'armes|possession d'un élément essentiel d'arme|possesso di parti essenziali di armi|possesso di una parte essenziale di arma|possess da parts essenzialas d’armas|possess d'ina part essenziala d’arma
Übertragung eines wesentlichen Waffenbestandteils|Übertragung von wesentlichen Waffenbestandteilen|aliénation d'un élément essentiel d'arme|aliénation d'éléments essentiels d'armes|alienazione di una parte essenziale di arma|alienazione di parti essenziali di armi|transferiment d'ina part essenziala d’ina arma|transferiment da parts essenzialas d’armas
Übertragung einer Waffe|aliénation d'une arme|alienazione di un'arma|transferiment d'ina arma
Waffenerwerbsscheinspflicht|Waffenerwerbsscheinpflicht|obligation d'être titulaire d'un permis d'acquisition d'armes|obbligo del permesso d'acquisto d'armi|obligaziun d’ina permissiun d’acquistar armas
Jagdgewehr|fusil de chasse|fucile da caccia|schluppet da chatscha
einschüssiges Jagdgewehr|fusil de chasse à un coup|fucile da caccia a colpo singolo|schluppet da chatscha a culp singul
mehrläufiges Jagdgewehr|fusil de chasse à plusieurs coups|fucile da caccia a più canne|schluppet da chatscha a pliras chonnas
Vorderlader|Vorderladerwaffe|Vorderladewaffe|muzzle-loading firearm|muzzle loader|arme à chargement par la bouche|fusil à chargement par la bouche|arma ad avancarica|schluppet per chargiar davant en
einschüssiger Vorderlader|einschüssige Vorderladerwaffe|arma ad avancarica a colpo singolo|schluppet a culp singul per chargiar davant en
Kaninchentöter|Flobertgewehr|Flobert|pistolet à lapins|flobert|pistola per l'uccisione di conigli|pistola per conigli
einschüssiger Kaninchentöter|einschüssiges Flobertgewehr|einschüssiges Flobert|pistolet à lapins à un coup|flobert à un coup|flobert a colpo singolo|pistola a colpo singolo per l'uccisione di conigli|flobert a culp singul
Waffenart|type d'arme|tipo d'arma|gener d’arma
leihweise Abgabe von Sportwaffen an unmündige Personen|prêt d'armes de sport à des mineurs|consegna a titolo di prestito di armi da sport a minorenni|emprest d’armas da sport a persunas minorennas
Besitz eines besonders konstruierten Waffenbestandteils|Besitz von besonders konstruierten Waffenbestandteilen|possession d'un composant d'arme spécialement conçu|possession de composants d'arme spécialement conçus|possesso di una parte di arma costruita appositamente|possesso di parti di armi costruite appositamente|possess d'ina part d’ina arma construida spezialmain|possess da parts d’ina arma construidas spezialmain
Besitz eines Waffenzubehörs|Besitz von Waffenzubehör|possession d'un accessoire d'arme|possession d'accessoires d'arme|possesso di un accessorio di un'arma|possesso di accessori di un'arma|possesso di accessori di armi|possess d'in accessori d’ina arma|possess d'accessoris d’ina arma
Waffenherstellung|Herstellung von Waffen|Herstellen von Waffen|fabrication d'armes|fabbricazione di armi|producziun d’armas
gewerbsmässiges Herstellen von Waffen|gewerbsmässige Herstellung von Waffen|gewerbsmässige Waffenherstellung|fabrication d'armes à titre professionnel|fabbricazione di armi a titolo professionale|producziun d’armas a titel professiunal
nichtgewerbsmässiges Herstellen von Waffen|nichtgewerbsmässige Herstellung von Waffen|nichtgewerbsmässige Waffenherstellung|fabrication d'armes à titre non professionnel|fabbricazione di armi a titolo non professionale|producziun d’armas a titel betg professiunal
gewerbsmässiges Reparieren von Waffen|réparation d'armes à titre professionnel|riparazione di armi a titolo professionale|reparaziun d’armas a titel professiunal
Umbauen von Waffen|Umbau von Waffen|transformation d'armes|modifica di armi|transfurmaziun d’armas
gewerbsmässiges Umbauen von Waffen|gewerbsmässiger Umbau von Waffen|transformation d'armes à titre professionnel|modifica di armi a titolo professionale|transfurmaziun d’armas a titel professiunal
nichtgewerbsmässiges Umbauen von Waffen|nichtgewerbsmässiger Umbau von Waffen|transformation d'armes à titre non professionnel|modifica di armi a titolo non professionale|transfurmaziun d’armas a titel betg professiunal
Markierung von Feuerwaffen|marquage des armes à feu|contrassegno di armi da fuoco|marcaziun d’armas da fieu
markierte Feuerwaffe|arme à feu marquée|arma da fuoco contrassegnata|arma da fieu marcada
unmarkierte Feuerwaffe|arme à feu non marquée|arma da fuoco non contrassegnata|arma da fieu betg marcada
Markierung von Munition|Munitionsmarkierung|marquage des munitions|contrassegno di munizioni|marcaziun da muniziun
Wiederladen von Munition für den Eigengebrauch|recharge de munitions destinées à un usage personnel|ricarica di munizioni per uso proprio|rechargia da muniziun per il diever persunal
Umbau von halbautomatischen Feuerwaffen zu Seriefeuerwaffen|Umbauen von halbautomatischen Feuerwaffen zu Seriefeuerwaffen|transformation d'armes à feu semi-automatiques en armes automatiques|trasformazione di armi da fuoco semiautomatiche in armi da fuoco per il tiro a raffica|transfurmaziun d'armas da fieu mez automaticas en armas da fieu a seria
Waffennummer|numéro d'arme|numero di controllo dell'arma|numer da l'arma
Begleitschein für die Ausfuhr von Feuerwaffen, deren wesentlichen Bestandteile oder der dazugehörigen Munition in einen Schengen-Staat|Waffenbegleitschein|Begleitschein|document de suivi pour l'exportation d'armes à feu, d'élémets essentiels d'armes et de la munition correspondante|document de suivi|bolletta di scorta per l'esportazione di armi da fuoco, di loro parti essenziali o delle relative munizioni in Stato Schengen|bolletta di scorta|fegl accumpagnant per l'export d'armas da fieu, da lur parts essenzialas u da muniziun en in stadi da Schengen|fegl accumpagnant
gewerbsmässiges Verbringen in das schweizerische Staatsgebiet|introduction sur le territoire suisse à titre professionnel|introduzione a titolo professionale sul territorio svizzero|apport a titel professiunal en il territori svizzer
nichtgewerbsmässiges Verbringen in das schweizerische Staatsgebiet|introduction sur le territoire suisse à titre non professionnel|introduzione a titolo non professionale sul territorio svizzero|apport a titel betg professiunal en il territori svizzer
gewerbsmässiges Verbringen von Messern in das schweizerische Staatsgebiet|introduction de couteaux sur le territoire suisse à titre professionnel|introduzione a titolo professionale di coltelli sul territorio svizzero|apport a titel professiunal da cuntels en il territori svizzer
vorübergehendes Verbringen von Nichtfeuerwaffen in das schweizerische Staatsgebiet|vorübergehende Verbringung von Nichtfeuerwaffen in das schweizerische Staatsgebiet|introduction provisoire d'armes autres que des armes à feu sur le territoire suisse|introduzione temporanea di armi bianche sul territorio svizzero|apport temporar d'autras armas che armas da fieu en il territori svizzer
vorübergehendes Verbringen von Feuerwaffen im Reiseverkehr|vorübergehende Verbringung von Feuerwaffen im Reiseverkehr|introduction provisoire d'armes à feu dans le trafic des voyageurs|introduzione temporanea di armi da fuoco nel traffico passeggeri|apport temporar d’armas da fieu en il traffic da viadi
vorübergehende Ausfuhr von Feuerwaffen im Reiseverkehr|exportation provisoire d'armes à feu dans le trafic des voyageurs|esportazione temporanea di armi da fuoco nel traffico passeggeri|export temporar d’armas da fieu en il traffic da viadi
Generalbewilligung für Nichtfeuerwaffen, Munition und Munitionsbestandteile|Generalbewilligung für Nichtfeuerwaffen|autorisation générale pour les armes autres que des armes à feu, les munitions et les éléments de munitions|autorisation générale pour les armes autres que des armes à feu|autorizzazione generale per armi bianche, munizioni ed elementi di munizioni|autorizzazione generale per armi bianche|permissiun generala per autras armas che armas da fieu, muniziun ed elements da muniziun|permissiun generala per autras armas che armas da fieu
Generalbewilligung für Waffen, Waffenbestandteile und Munition|autorisation générale pour les armes, les éléments essentiels d'armes et les munitions|autorizzazione generale per armi, parti di armi e munizioni|permissiun generala per armas, accessoris d’armas e muniziun
Mitglied ausländischer Streitkräfte|membre de forces armées étrangères|membro di forze armate estere|commember da forzas armadas estras
staatlich beauftragter Sicherheitsbegleiter|staatlich beauftragte Sicherheitsbegleiterin|agent de sécurité mandaté par l’État|agent de sécurité mandaté par la Confédération ou un État étranger|agente di sicurezza con mandato statale|agent da segirezza cun in mandat statal
Sicherheitsbegleiter|Sicherheitsbegleiterin|agent de sécurité|agente de sécurité|agente di sicurezza|agent da segirezza
Mitarbeiter einer ausländischen Grenzschutzbehörde|Mitarbeiterin einer ausländischen Grenzschutzbehörde|collaborateur d'une autorité étrangère chargée de la surveillance des frontières|collaboratrice d'une autorité étrangère chargée de la surveillance des frontières|collaboratore di un'autorità estera di protezione dei confini|collaboratrice di un'autorità estera di protezione dei confini|collavuratur d’ina autoritad estra da guardia da cunfin
Mitarbeiter der schweizerischen Grenzschutzbehörde|Mitarbeiterin der schweizerischen Grenzschutzbehörde|collaborateur de l'autorité suisse de surveillance des frontières|collaboratrice de l'autorité suisse de surveillance des frontières|collaboratore dell'autorità svizzera di protezione dei confini|collaboratrice dell'autorità svizzera di protezione dei confini|collavuratur da l'autoritad svizra da guardia da cunfin
Mitglied einer ausländischen Polizeibehörde|Mitarbeiter einer ausländischen Polizeibehörde|Mitarbeiterin einer ausländischen Polizeibehörde|membre d'une autorité policière étrangère|collaborateur d'une autorité policière étrangère|collaboratrice d'une autorité policière étrangère|membro di un'autorità di polizia estera|collaboratore di un'autorità di polizia estera|collaboratrice di un'autorità di polizia estera|commember d’ina autoritad da polizia estra|collavuratur d’ina autoritad da polizia estra
Aufbewahren von Waffen|Aufbewahrung von Waffen|conservation d'armes|custodia di armi
Transportieren von Waffen|Transport von Waffen|Waffentransport|transport d'armes|trasporto di armi|transport d'armas
Aufbewahren von Munition|Aufbewahrung von Munition|conservation de munitions|custodia di munizioni
Tragen von Munition|port de munitions|porto di munizioni
Transportieren von Munition|Transport von Munition|Munitionstransport|transport de munitions|trasporto di munizioni
Inhaber einer Jagdbewilligung|Inhaberin einer Jagdbewilligung|titulaire d'un permis de chasse|titolare di una licenza di caccia|titular d’ina patenta da chatscha
Transport von Feuerwaffen|Transportieren von Feuerwaffen|Feuerwaffentransport|transport d'armes à feu|trasporto di armi da fuoco|transport d'armas da fieu
Rahmenbewilligung auf dem Gebiet der schweizerischen Flughäfen|autorisation générale pour le périmètre des aéroports suisses|autorizzazione quadro nelle aree degli aeroporti svizzeri|permissiun generala sin il territori da las plazzas aviaticas svizras
Beschlagnahme von Waffen|Waffenbeschlagnahme|mise sous séquestre d'armes|sequestro di armi|sequestraziun d'armas
Einziehung von Waffen|Einziehen von Waffen|confiscation d'armes|confisca di armi|confiscaziun d'armas
Entgegennahme von Waffen durch die Kantone|reprise d'armes par les cantons|presa in consegna di armi da parte dei Cantoni|recepziun d’armas tras ils chantuns
Schusswaffenspur|Spur von Schusswaffen|trace d'armes à feu|trace d'armes|traccia di armi da fuoco|fastiz d’armas da fieu
Aufbewahrung beschlagnahmter Waffen|Aufbewahren beschlagnahmter Waffen|conservation d'armes mises sous séquestre|custodia di armi sequestrate
DEWA|Datenbank über den Erwerb von Waffen durch ausländische Staatsangehörige ohne Niederlassungsbewilligung|Banque de données relative à l'acquisition d'armes par des ressortissants étrangers non titulaires d'un permis d'établissement|Banca dati sull'acquisto di armi da parte di cittadini stranieri senza permesso di domicilio|Banca da datas davart l’acquist d’armas tras burgais esters senza permissiun da domicil
DEWS|Datenbank über den Erwerb von Waffen durch Personen mit Wohnsitz in einem andern Schengen-Staat|Banque de données relative à l'acquisition d'armes par des personnes domiciliées dans un autre État Schengen|Banca dati sull'acquisto di armi da parte di persone domiciliate in un altro Stato Schengen|Banca da datas davart l’acquist d’armas tras persunas cun domicil en in auter stadi da Schengen
DEBBWA|Datenbank über den Entzug und die Verweigerung von Bewilligungen und die Beschlagnahme von Waffen|Banque de données relative au refus de délivrer des autorisations, à la révocation d'autorisations et à la mise sous séquestre d'armes|Banca dati sul rifiuto e la revoca di autorizzazioni e sul sequestro di armi|Banca da datas davart la revocaziun e davart la refusa da permissiuns e davart la sequestraziun d’armas
DAWA|Datenbank über die Überlassung von Waffen der Armee zu Eigentum|Banque de données relative à la remise en toute propriété d'armes de l'armée|Banca dati sulla cessione in proprietà di armi dell'esercito|Banca da datas davart la surlaschada d’armas da l’armada sco proprietad
DARUE|Datenbank über Markierungen zur Rückverfolgbarkeit von Feuerwaffen und deren Munition|Banque de données relative au marquage destiné au traçage des armes à feu et de leurs munitions|Banca dati sui contrassegni destinati a garantire la tracciabilità delle armi da fuoco e delle loro munizioni|Banca da datas davart las marcaziuns per repersequitar armas da fieu e lur muniziun
persönliche Leihwaffe|arme personnelle en prêt|arma personale in prestito|arma persunala ad emprest
unpersönliche Leihwaffe|arme non personnelle en prêt|arma non personale in prestito|arma in prestito a titolo non personale|arma nunpersunala ad emprest
Sprayprodukt|Spray|spray
Ordonnanzdolch|poignard d'ordonnance|pugnale d'ordinanza|stilet d'ordonanza
Ordonnanzbajonett|baïonnette d'ordonnance|baionetta d'ordinanza|baionetta d'ordonanza
Erwerb durch Erbgang|acquisition par dévolution successorale|acquisto per successione ereditaria|acquist tras successiun ereditara
Schiessverbot|interdiction de tir|divieto di tiro|scumond da tir
Ordonnanzrepetiergewehr|fusil à répétition d'ordonnance|fusil d'ordonnance à répétition manuelle|fucile a ripetizione d'ordinanza|carabina a ripetizione d'ordinanza|schluppet a repetiziun d'ordonanza
Sportgewehr|fusil de sport|fucile da sport|schluppet da sport
Militärkalibermunition|munition de calibre militaire|munizione di calibro militare|muniziun da caliber militar
Sportkalibermunition|munition de calibre de sport|munizione di calibro sportivo|muniziun da caliber sportiv
Standardgewehr mit einem Verschlussrepetiersystem|Standardgewehr mit Verschlussrepetiersystem|fusil standard à système de culasse à répétition|fucile standard con sistema di culatta a ripetizione|schluppet da standard cun sistem da serradira a repetiziun
Repetiergewehr|fusil à répétition|fucile a ripetizione|schluppet a repetiziun
Repetiergewehr mit einem Vorderschaftsrepetiersystem|Vorderschaftrepetierer|Pump-Action-Gun|Pump-Gun|pump action gun|pump gun|fusil à répétition avec système à pompe|fusil à répétition muni d'un système à pompe|fusil à pompe|pump-gun|fucile con sistema di ripetizione a pompa|fucile a ripetizione a canna liscia|fucile a pompa|pump-action-gun|schluppet a repetiziun cun sistem a pumpa|schluppet a pumpa
Repetiergewehr mit einem Unterhebelrepetiersystem|Unterhebelrepetierer|lever action gun|fusil à répétition à levier de sous-garde|fusil à levier de sous-garde|carabine à répétition à levier de sous-garde|fucile a ripetizione con leva guardamano|fucile con leva guardamano|carabina a ripetizione con leva guardamano|schluppet a repetiziun cun in sistem da levagl sut
ISSF|International Shooting Sport Federation|Fédération internationale de tir sportif|Federazione Internazionale Sport del tiro
Sportschiessen|sportliches Schiessen|Schiesssport|tir sportif|tiro sportivo|tir da sport
jagdschiesssportlicher Wettbewerb|concorso di tiro di caccia sportiva|concurrenza da tir da chatscha sportiva
typengeprüfte Waffe|arme homologuée|arme munie d'un numéro d'homologation|arme examinée|arma omologata|arma contrassegnata da un numero di omologazione|arma omologada|arma provedida cun in numer d'omologaziun|arma examinada
verbotene Munition|munition prohibée|munizione vietata|muniziun scumandada
Munition mit Hartkerngeschossen|munition à noyau dur|munizione con proiettili a nucleo duro|muniziun cun projectils a nuschegl dir
Munition für Faustfeuerwaffen mit Deformationswirkung|Deformationsmunition|Deformationsgeschoss|munition à projectiles expansifs pour armes à feu de poing|munition à projectiles expansifs|balle expansive|munizione per armi da pugno con effetto deformante|munizione deformante|proiettile deformante|muniziun per armas curtas cun effect defurmant|muniziun defurmanta|projectil defurmant
Munition für Faustfeuerwaffen mit hoher Penetrationsleistung|munition à grande capacité de pénétration pour armes à feu de poing|munizione per armi da pugno con elevata capacità di penetrazione|muniziun per armas curtas cun gronda capacitad da penetraziun
Gesuch um Erteilung einer Waffenhandelsbewilligung|demande de patente de commerce d'armes|domanda per il rilascio di una patente di commercio di armi|dumonda da permissiun per il commerzi cun armas
Waffenbörse|bourse aux armes|borsa delle armi|mercato di armi|bursa d'armas
Verpackungseinheit von Munition|unité d'emballage de munitions|unità d'imballaggio di munizioni|unitad d'emballadi da muniziun
Abändern von Waffennummern|modification de numéros d'armes|modifica dei numeri di controllo delle armi|modificaziun da numers d'armas
Entfernen von Waffennummern|suppression de numéros d'armes|rimozione dei numeri di controllo delle armi
Bewilligung für gewerbsmässiges Verbringen in das schweizerische Staatsgebiet|autorisation d'introduction sur le territoire suisse à titre professionnel|autorizzazione per l'introduzione nel territorio svizzero a titolo professionale|autorisaziun per l'introducziun professiunala en il territori svizzer
Bewilligung für nichtgewerbsmässiges Verbringen in das schweizerische Staatsgebiet|autorisation d'introduction sur le territoire suisse à titre non professionnel|autorizzazione per l'introduzione nel territorio svizzero a titolo non professionale|autorisaziun per l'introducziun nunprofessiunala en il territori svizzer
Bewilligung für vorübergehendes Verbringen von Feuerwaffen im Reiseverkehr in das schweizerische Staatsgebiet|autorisation d'introduction provisoire sur le territoire suisse d'armes à feu dans le trafic des voyageurs|autorizzazione per l'introduzione temporanea nel territorio svizzero di armi da fuoco nel traffico passeggeri|autorisaziun per l'introducziun temporara d'armas da fieu en il territori svizzer en il traffic da persunas
Bewilligung für vorübergehendes Verbringen von Feuerwaffen durch Sicherheitsbegleiter in das schweizerische Staatsgebiet|autorisation d'introduction provisoire sur le territoire suisse d'armes à feu pour les agents de sécurité|autorizzazione per l'introduzione temporanea nel territorio svizzero di armi da fuoco da parte di agenti di sicurezza|autorisaziun per l'introducziun temporara en il territori svizzer d'armas da fieu tras funcziunaris da segirezza
Mündungsenergie|Mündungswucht|énergie à la bouche|energia alla bocca|energia a la sbuccada
Schleuder mit Armstütze|fronde avec repose-bras|fionda dotata di appoggia-braccio|fionda con appoggia-braccio|funda cun support dal bratsch|schlingia cun support dal bratsch
einhändig bedienbares Messer mit automatischem Mechanismus|coltello con meccanismo automatico di apertura della lama azionabile con una sola mano|cuntè cun mecanissem automatic per avrir cun in maun
Nunchaku|Würgeholz|nunchaku|lain per stranglar
Tonfa|tonfa|tong fa|tuifa
Pfefferspray|spray au poivre|spray al pepe|vapurisader da paiver|spray da paiver
zweihändig bedienbares Klappmesser|couteau à lame pivotante actionnable à deux mains|coltello a serramanico utilizzabile con due mani|cuntè plegabel per duvrar cun dus mauns
einhändig manuell bedienbares Klappmesser|couteau à cran d'arrêt actionnable à une seule main|coltello apribile con una sola mano|cuntè plegabel per avrir cun in maun
Dolch mit asymmetrischer Klinge|poignard à lame asymétrique|pugnale a lama asimmetrica|stilet cun loma asimmetrica
Samurai-Schwert|sabre de samouraï|spada da samurai
Schleuder ohne Armstütze|fronde sans repose-bras|fionda senza appoggia-braccio|funda senza support dal bratsch|schlingia senza support dal bratsch
bewilligungspflichtige Waffe|arme soumise à autorisation|arma soggetta all'obbligo di autorizzazione|arma suttamessa ad in'autorisaziun
meldepflichtige Waffe|arme soumise à déclaration|arma soggetta all'obbligo di dichiarazione|arma che suttastat a l'obligaziun d'annunzia
verbotene Waffe|arme interdite|arma vietata|arma scumandada
Nachbildung eines einschüssigen Vorderladers|replica di un'arma ad avancarica a colpo singolo|reproducziun d'in schluppet a culp singul per chargiar davant en
Handrepetiergewehr|manual repeating rifle|fusil à répétition manuelle|fucile a ripetizione portatile|schluppet a repetiziun manuala
Selbstladebüchse|carabine semi-automatique|carabina a canna rigata semiautomatica|schluppet automatic
Selbstladeflinte|fusil semi-automatique à canon lisse|fucile semiautomatico a canna liscia|flinta automatica
halbautomatisches Gewehr|fusil semi-automatique|fucile semiautomatico|schluppet semiautomatic|schluppet mez automatic
Erwerb von Schlagstöcken|acquisition de matraques|acquisto di bastoni da combattimento|acquist da bastuns
definitive Ausfuhr von Feuerwaffen|exportation définitive d’armes à feu|esportazione definitiva di armi da fuoco|export definitiv d'armas da fieu
Geschoss mit Sprengwirkung|projectile à effet explosif|proiettile con effetto dirompente|projectil cun effect explosiv
Hinterlegung der Ordonnanzwaffe|Hinterlegen der Ordonnanzwaffe|dépôt de l'arme d'ordonnance|deposito dell'arma d'ordinanza|deposit da l'arma d'ordonanza
Übernahme der Ordonnanzwaffe nach dem Ausscheiden aus der Armee|reprise de l'arme d'ordonnance lors du départ de l'armée|cessione in proprietà dell'arma d'ordinanza a chi lascia l'esercito|surpigliada da l'arma d'ordonanza suenter l'extrada da l'armada
Handrepetierer|carabine à répétition manuelle|carabina a ripetizione portatile|schluppet a repetiziun manuala
